a	Numeral	ɑː
aa	Noun	ˈɑː.ɑː
aakkonen	Noun	ˈɑːkːonen
aakkosellinen	Adjective	ˈɑːkːoselːinen
aakkosellisuuden	Noun	ˈɑːkːoˌselːiˌsuːden
aakkosen	Noun	ˈɑːkːosen
aakkosjärjestys	Noun	ˈɑːkːosjærjestys
aakkosta	Noun	ˈɑːkːostɑ
aakkostaa	Verb	ˈɑːkːo̞stɑːˣ
aakkoston	Noun	ˈɑːkːoston
aakkostuksen	Noun	ˈɑːkːosˌtuksen
aalloittaisuuden	Noun	ˈɑːlːoˌt̪ːɑisuːden
aallokas	Adjective	ˈɑːlːo̞kɑs
aallonmurtaja	Noun	ˈɑːlːoˌmːurtɑjɑ
aallot	Noun	ˈɑːlːo̞t̪
aallota	Verb	ˈɑːlːo̞t̪ɑˣ
aallottaa	Verb	ˈɑːlːo̞t̪ːɑːˣ
aalto	Noun	ˈɑːl̪t̪o̞
aaltoa	Noun	ˈɑːltoɑ
aaltohiukkasdualismi	Noun	ˈɑːlto̞ˌhiukːɑsˌduɑlismi
aaltoileva	Adjective	ˈɑːltoiˌleʋɑ
aaltoilla	Verb	ˈɑːl̪t̪o̞ilːɑˣ
aaltoillen	Verb	ˈɑːltoilːen
aaltosulku	Noun	ˈɑːlt̪o̞ˌsulku
aaltoviiva	Noun	ˈɑːltoˌʋiːʋɑ
aaltovoima	Noun	ˈɑːlto̞ˌʋo̞imɑ
aamiainen	Noun	ˈɑːmiɑinen
aamiaismajoitus	Noun	ˈɑːmiɑi̯smɑjoi̯tus
aamiaistaa	Verb	ˈɑːmiɑistɑːˣ
aamu	Noun	ˈɑːmu
aamuhämärä	Noun	ˈɑːmuˌhæmæræ
aamulepakko	Noun	ˈɑːmuˌle̞pɑkːo̞
aamupala	Noun	ˈɑːmuˌpɑlɑ
aamupäivä	Noun	ˈɑːmuˌpæi̯ʋæ
aamutähti	Noun	ˈɑːmuˌtæhti
aamuvuoro	Noun	ˈɑːmuˌʋuɔro̞
aamuyö	Noun	ˈɑːmuˌyø̯
aapasuo	Noun	ˈɑːpɑˌsuo
aapinen	Noun	ˈɑːpinen
aari	Noun	ˈɑːri
aaria	Noun	ˈɑːriɑ
aarnialue	Noun	ˈɑːrniˌɑlue(ʔ)
aarnikotka	Noun	ˈɑːrniˌkotkɑ
aarniometsä	Noun	ˈɑːrnioˌmetsæ
aaroninsauva	Noun	ˈɑːroninˌsɑuʋːɑ
aarre	Noun	ˈɑːrːe̞ˣ
aarrearkku	Noun	ˈɑːrːeˌɑrkːu
aarresaari	Noun	ˈɑːrːe̞ˌsːɑːri
aasa	Noun	ˈɑːsɑ
aasainuskoinen	Noun	ˈɑːsɑjnˌuskojnen
aasi	Noun	ˈɑːsi
aate	Noun	ˈɑːt̪e̞ˣ
aateli	Noun	ˈɑːt̪e̞li
aatelinen	Noun	ˈɑːt̪e̞line̞n
aatelismies	Noun	ˈɑːt̪e̞lisˌmie̞s
aatelisnainen	Noun	ˈɑːt̪e̞lisˌnɑine̞n
aateloida	Verb	ˈɑːteloidɑ(ʔ)
aatelointi	Noun	ˈɑːt̪e̞lo̞in̪t̪i
aatos	Noun	ˈɑːtos
aatra	Noun	ˈɑːtrɑ
aatto	Noun	ˈɑːt̪ːo̞
aava	Adjective	ˈɑːʋɑ
aave	Noun	ˈɑːʋe̞ˣ
aavikko	Noun	ˈɑːʋikːo
aavikkokenguru	Noun	ˈɑːʋikːoˌkeŋːuru
aavikkopöllö	Noun	ˈɑːʋikːoˌpølːø
aavikoituminen	Noun	ˈɑːʋiˌkoituminen
aavistaa	Verb	ˈɑːvistɑː(ʔ)
abbedissa	Noun	ˈɑːbːedisːɑ
aberraatio	Noun	ˈɑbeˌrːɑːtio
abessiivi	Noun	ˈɑbeˌsːiːʋi
abi	Noun	ˈɑbi
ablatiivi	Noun	ˈɑblɑˌtiːʋi
abnormi	Adjective	ˈɑbnormi
abortoida	Verb	ˈɑbortoidɑ(ʔ)
abortti	Noun	ˈɑbortːi
abrakadabra	Noun	ˈɑbrɑkɑˌdɑbrɑ
absintti	Noun	ˈabsintːi
absoluutti	Noun	ˈɑbsoˌluːtːi
absorboida	Verb	ˈɑbsorboidɑ(ʔ)
absorboitua	Verb	ˈɑbsorboituɑ(ʔ)
abstrahoida	Verb	ˈɑbstrɑˌhoidɑ(ʔ)
abstraktio	Noun	ˈɑbstrɑkt̪io̞
adamantiini	Noun	ˈɑdɑmɑntiːni
adapteri	Noun	ˈɑdɑpteri
adapterit	Noun	ˈɑdɑpt̪e̞rit̪
adaptoida	Verb	ˈɑdɑpˌtoidɑ(ʔ)
adaptoitua	Verb	ˈɑdɑptoi̯tuɑˣ
addiktio	Noun	ˈɑdːikt̪i.o
adessiivi	Noun	ˈɑdeˌsːiːʋi
adjektiivi	Noun	ˈɑdjekˌtiːʋi
adoptio	Noun	ˈɑdoptio
adoptoida	Verb	ˈɑdoptoidɑ(ʔ)
adoptointi	Noun	ˈɑdo̞pt̪o̞in̪t̪i
adpositio	Noun	ˈɑdpositio
adrenaliini	Noun	ˈɑdrenɑˌliːni
adressi	Noun	ˈɑdresːi
adressia	Noun	ˈɑdresːiɑ
adventti	Noun	ˈɑdʋentːi
adventtikalenteri	Noun	ˈɑdʋentːiˌkɑlenteri
adverbi	Noun	ədˈvɛɾ.bi
adverbiaali	Noun	ˈɑdʋerbiɑːli
aedeagus	Noun	iˈdi.ə.ɡəs
aerobikata	Verb	ˈɑeroˌbikɑtɑ(ʔ)
aerosoli	Noun	ˈɑeroˌsoli
afgaani	Noun	ˈɑfɡɑːni
afrikkalainen	Adjective	ˈɑfrikːɑˌlɑinen
agentti	Noun	ˈɑɡen̪t̪ːi
agglutinoida	Verb	ˈɑɡlutiˌnoidɑ(ʔ)
aggressiivisuus	Noun	ˈɑɡːresːiːʋisuːs
agitoida	Verb	ˈɑɡitoidɑ(ʔ)
agnostikko	Noun	ˈɑŋnostikːo
agonia	Noun	ˈɑɡoniɑ
agorafobia	Noun	ˈɑɡorɑfobiɑ
ahaa	Interjection	ˈɑɦɑː
ahavoittaa	Verb	ˈɑɦɑvoitːɑː(ʔ)
ahavoitua	Verb	ˈɑɦɑvoituɑ(ʔ)
ahdata	Verb	ˈɑɦdɑt̪ɑˣ
ahdin	Noun	ˈɑɦdin
ahdistaa	Verb	ˈɑhdistɑː(ʔ)
ahdistelu	Noun	ˈɑɦdistelu
ahdistua	Verb	ˈɑhdistuɑ(ʔ)
ahdistushäiriö	Noun	ˈɑhdistusˌhæiriø
ahertaa	Verb	ˈɑhertɑː(ʔ)
ahjo	Noun	ˈɑhjo
ahkera	Adjective	ˈɑxke̞rɑ
ahkeroida	Verb	ˈɑhkeroidɑ(ʔ)
ahmaista	Verb	ˈɑɦmɑistɑ(ʔ)
ahmia	Verb	ˈɑɦmi.ɑˣ
ahmimishäiriö	Noun	ˈɑhmimisˌhæiriø
ahnasta	Adjective	ˈɑɦnɑstɑ
ahne	Adjective	ˈɑɦne̞ˣ
ahnehtia	Verb	ˈɑhnehtiɑ(ʔ)
ahneus	Noun	ˈɑhneus
aho	Noun	ˈɑɦo
aholeinikki	Noun	ˈɑhoˌleinikːi
ahomansikka	Noun	ˈɑhoˌmɑnsikːɑ
ahtaa	Verb	ˈɑxtɑː(ʔ)
ahtaneeksi	Verb	ˈɑhtɑneːksi
ahtaneella	Verb	ˈɑhtɑneːlːɑ
ahtaneelle	Verb	ˈɑhtɑneːlːe(ʔ)
ahtaneelta	Verb	ˈɑhtɑneːltɑ
ahtaneen	Verb	ˈɑhtɑneːn
ahtaneena	Verb	ˈɑhtɑneːnɑ
ahtaneeseen	Verb	ˈɑhtɑneːseːn
ahtaneessa	Verb	ˈɑhtɑneːsːɑ
ahtaneesta	Verb	ˈɑhtɑneːstɑ
ahtaneetta	Verb	ˈɑhtɑneːtːɑ
ahtanutta	Verb	ˈɑhtɑnutːɑ
ahtauttaa	Verb	ˈɑhtɑutːɑː(ʔ)
ahtautua	Verb	ˈɑxt̪ɑut̪u.ɑˣ
ahti	Noun	ˈɑxt̪i
ahven	Noun	ˈɑɦʋen
ahvenanmaanlammas	Noun	ˈɑħʋenɑˌmːɑːnˌlɑmːɑs
ai	Noun	ˈɑ.i
aiai	Noun	ˈɑiɑi
aidas	Verb	ˈɑidɑs
aidata	Verb	ˈɑidɑtɑˣ
aie	Noun	ˈɑie̞ˣ
aihe	Noun	ˈɑihe
aihetodiste	Noun	ˈɑiɦeˌtodiste
aiheuttaa	Verb	ˈɑiheutːɑː(ʔ)
aiheutua	Verb	ˈɑiɦeutuɑ(ʔ)
aihio	Noun	ˈaiɦi.o̞
aijai	Interjection	ˈɑijːɑi
aika	Noun	ˈɑi̯kɑ
aikaansaada	Verb	ˈɑikɑːnˌsɑːdɑ
aikailla	Verb	ˈɑikɑilːɑ(ʔ)
aikaillen	Verb	ˈɑikɑilːen
aikainen	Adjective	ˈɑikɑinen
aikaisheteisyys	Noun	ˈɑikɑisˌheteisyːs
aikaistaa	Verb	ˈɑikɑistɑː(ʔ)
aikaistua	Verb	ˈɑikɑistuɑ(ʔ)
aikamatkailu	Noun	ˈɑikɑˌmɑtkɑilu
aikamoinen	Adjective	ˈɑikɑˌmoinen
aikana	Noun	ˈɑikɑnɑ
aikatauluttaa	Verb	ˈɑikɑˌtɑulutːɑː(ʔ)
aikoa	Verb	ˈɑi̯koɑˣ
aikuistua	Verb	ˈɑikuistu.ɑˣ
ailahdella	Verb	ˈɑilɑxde̞lːɑ
ailahdellen	Verb	ˈɑilɑhdelːen
ailahtaa	Verb	ˈɑilɑxt̪ɑːˣ
ailurofobia	Noun	ˈɑi̯lurofobiɑ
aimo	Adverb	ˈɑimo̞
aina	Adjective	ˈɑinɑ
aine	Noun	ˈɑi̯neˣ
aineenvaihdunta	Noun	ˈɑine̞ːnˌʋaiçdun̪t̪ɑ
aineet	Noun	ˈɑine̞ːt̪
ainemäärä	Noun	ˈɑine̞ˌmːæːræ
aines	Noun	ˈɑines
aino	Noun	ˈɑino
ainoa	Adjective	ˈɑino̞ɑ
ainokainen	Noun	ˈɑino̞kɑine̞n
ainuntaa	Verb	ˈɑi̯nuntɑːˣ
ainut	Adjective	ˈɑinut̪
aio	Verb	ˈɑijo̞
airo	Noun	ˈɑiro̞
airut	Noun	ˈɑirut̪
ais	Noun	ɑis
aisa	Noun	ˈɑisɑ
aistia	Verb	ˈɑisti.ɑˣ
aistiharha	Noun	ˈɑistiˌxɑrxɑ
aistikas	Adjective	ˈɑistikɑs
aistin	Noun	ˈɑistin
aita	Noun	aiˈta
aitaa	Noun	ˈɑitɑː
aitio	Noun	ˈɑitio
aitolehti	Noun	ˈɑitoˌlehti
aitomaksasammal	Noun	ˈɑitoˌmɑksɑˌsɑmːɑl
aitosammal	Noun	ˈɑitoˌsɑmːɑl
aitotumainen	Adjective	ˈɑitoˌtumɑinen
aitta	Noun	ˈɑit̪ːɑ
aivan	Adverb	ˈɑiʋɑn
aivastava	Verb	ˈɑiʋɑstɑʋɑ
aivokalvontulehdus	Noun	ˈɑivoˌkɑlvonˌtuleɦdus
aivokirurgi	Noun	ˈɑiʋoˌkirurɡi
aivokuori	Noun	ˈɑiʋoˌkuɔri
aivokurkiainen	Noun	ˈɑiʋoˌkurkiɑinen
aivokuume	Noun	ˈɑiʋoˌkuːme(ʔ)
aivokäyrä	Noun	ˈɑiʋoˌkæyræ
aivolisäke	Noun	ˈɑiʋoˌlisæke(ʔ)
aivolohko	Noun	ˈɑiʋoˌlohko
aivopestä	Verb	ˈɑivoˌpestæ
aivosähkökäyrä	Noun	ˈɑiʋoˌsæhkøˌkæyræ
aivotoiminta	Noun	ˈɑiʋoˌtoimintɑ
aivotärähdys	Noun	ˈɑiʋoˌtæræhdys
aivovamma	Noun	ˈɑiʋoˌʋɑmːɑ
aivovaurio	Noun	ˈɑiʋoˌʋɑurio
aivoverenkiertohäiriö	Noun	ˈɑiʋoˌʋerenˌkiertoˌhæiriø
aja	Noun	ˈaː.jaː
ajaa	Verb	ˈɑjɑːˣ
ajaakarille	Verb	ˈɑjɑːˈkːɑrilːe̞
ajallinen	Adjective	ˈɑjɑlːinen
ajamaan	Verb	ˈɑjɑmɑːn
ajanlasku	Noun	ˈɑjɑnˌlɑsku
ajanviete	Noun	ˈɑjɑnˌʋie̞t̪e̞ˣ
ajatella	Verb	ˈɑjɑtelːɑˣ
ajatellen	Verb	ˈɑjɑtelːen
ajatollah	Noun	ˈɑjɑtolːɑh
ajattaja	Noun	ˈɑjɑtːɑjɑ
ajatuksekas	Adjective	ˈɑjɑˌt̪ukse̞kas
ajatuskoe	Noun	ˈɑjɑtusˌkoe(ʔ)
ajatusviiva	Noun	ˈɑjɑtusˌʋiːʋɑ
ajelehtia	Verb	ˈɑjelextiɑ(ʔ)
ajella	Verb	ˈɑje̞lːɑˣ
ajo	Pronoun	aˈjɔ
ajoittaa	Verb	ˈɑjoitːɑː(ʔ)
ajokoe	Noun	ˈɑjoˌkoe(ʔ)
ajoluiska	Noun	ˈɑjoˌluiskɑ
ajopurje	Noun	ˈɑjoˌpurje(ʔ)
ajorata	Noun	ˈɑjo̞ˌrɑt̪ɑ
akana	Noun	ˈɑkɑnɑ
akka	Noun	ˈɑkːɑ
akkautua	Verb	ˈɑkːɑutuɑ
akkusatorinen	Adjective	ˈɑkːusɑtorinen
akne	Noun	ˈɑkne
akryyli	Noun	ˈɑkryːli
akselinlaskija	Noun	ˈɑkselinˌlɑskijɑ
aksolotli	Noun	ˈɑkso̞lo̞t̪li
aksoni	Noun	ˈɑkso̞ni
aktiivi	Noun	ˈɑktiːvi
aktiivihiilisuodatin	Noun	ˈɑktiːʋiˌç̞iːliˌsuodɑtin
aktiivinen	Adjective	ˈɑkt̪iːʋine̞n
aktivoida	Verb	ˈɑkt̪iʋo̞idɑ(ʔ)
aktivoitua	Verb	ˈɑktiʋoi̯tuɑˣ
aktualisoitua	Verb	ˈɑktuɑlisoi̯tuɑˣ
akvarelli	Noun	ˈɑkʋɑre̞lːi
ala	Prefix	ˈɑlɑ
alaaste	Noun	ˈɑlɑʔˌɑste̞ˣ
alaikäinen	Adjective	ˈɑlɑˌikæinen
alaikäisenväkisinmakaaminen	Noun	ˈɑlɑˌikæisen ˈʋækisiˌmːɑkɑːminen
alakoulu	Noun	ˈɑlɑˌko̞ulu
alakulo	Noun	ˈɑlɑˌkulo
alalahko	Noun	ˈɑlɑˌlɑxko
alamäki	Noun	ˈɑlɑˌmæki
alanko	Noun	ˈɑlɑŋko
alapaine	Noun	ˈɑlɑˌpɑine(ʔ)
alaruumis	Noun	ˈɑlɑˌruːmis
alas	Interjection	əˈlæs
alaston	Adjective	ˈɑlɑsto̞n
alastulo	Noun	ˈɑlɑsˌt̪ulo̞
alasuku	Noun	ˈɑlɑˌsuku
alati	Adverb	ˈɑlɑt̪i
alaviiva	Noun	ˈɑlɑˌʋiːʋɑ
ale	Noun	eɪl
alemmuuskompleksi	Noun	ˈɑlemːuːsˌkompleksi
alennusmerkki	Noun	ˈɑlenːusˌmerkːi
alentaa	Verb	ˈɑlentɑː
alentua	Verb	ˈɑlentuɑ(ʔ)
aleta	Noun	ˈɑletɑˣ
aletaan	Verb	ˈɑletɑːn
alfa	Noun	ˈal.fə
alhainen	Adjective	ˈɑlxɑine̞n
alhaiso	Noun	ˈɑlhɑi̯so
ali	Noun	ˈɑli
aliarvioida	Verb	ˈɑliˌɑrʋioidɑ(ʔ)
aliarviointi	Noun	ˈɑliˌɑrʋiointi
alijäähtyminen	Noun	ˈɑliˌjæːhtyminen
alikulku	Noun	ˈɑliˌkulku
alikäytävä	Noun	ˈɑliˌkæytæʋæ
alilämpöisyys	Noun	ˈɑliˌlæmpøisyːs
alin	Adjective	ˈɑlin
aliravitsemus	Noun	ˈɑliˌrɑʋitsemus
alistaa	Verb	ˈɑlistɑː(ʔ)
alisteinen	Adjective	ˈɑlisteinen
alistua	Verb	ˈɑlistuɑ(ʔ)
alisuoriutuminen	Noun	ˈɑliˌsuoriuˌtuminen
alittaa	Verb	ˈɑlitːɑː(ʔ)
alittua	Verb	ˈɑlitːuɑ(ʔ)
alityöllisyys	Noun	ˈɑliˌtyølːisyːs
alkaa	Verb	ˈɑlkɑː(ʔ)
alkeisjuuri	Noun	ˈɑlkeisˌjuːri
alkeislehti	Noun	ˈɑlkeisˌlehti
alkeissilmu	Noun	ˈɑlkeisˌsilmu
alkeisvarsi	Noun	ˈɑlkeisˌʋɑrsi
alkio	Noun	ˈɑlkio
alkiokalvo	Noun	ˈɑlkioˌkɑlʋo
alkiorakko	Noun	ˈɑlkioˌrɑkːo
alkoholikäyminen	Noun	ˈɑlkoɦoliˌkæyminen
alkueliö	Noun	ˈɑlkuˌe̞liø̞
alkuerä	Noun	ˈɑlkuˌeræ
alkukala	Noun	ˈɑlkuˌkɑlɑ
alkunilviäinen	Noun	ˈɑlkuˌnilʋiæinen
alkuräjähdys	Noun	ˈɑlkuˌræjæcdys
alkusointu	Noun	ˈɑlkuˌsointu
alkusynty	Noun	ˈɑlkuˌsynty
alla	Interjection	ɑˈlaː
allakka	Noun	ˈɑlːɑkːɑ
allas	Noun	ˈɑlːɑs
allekirjoittaa	Verb	ˈɑlːekːirjoitːɑː(ʔ)
allekirjoittanut	Noun	ˈɑlːeˌkːirjoiˌtːɑnut
allergisuus	Noun	ˈɑlːerɡisuːs
alleviivata	Verb	ˈɑlːeˌʋːiːʋɑtɑ(ʔ)
alli	Noun	ˈɑlːi
allikko	Noun	ˈɑlːikːo
allilla	Noun	ˈɑlːilːɑ
allomorfi	Noun	ˈɑlːoˌmorfːi
almanakka	Noun	ˈɑlmɑnɑkːɑ
aloin	Noun	ˈɑloin
aloite	Noun	ˈɑlo̞it̪e̞ˣ
aloittaa	Verb	ˈɑloitːɑː(ʔ)
aloitteikas	Adjective	ˈɑlo̞iˌt̪ːe̞ikɑs
aloituspiste	Noun	ˈɑlo̞it̪usˌpiste̞ˣ
aloke	Noun	ˈɑlo̞ke̞ˣ
alpi	Noun	ˈɑlpi
alppikauris	Noun	ˈɑlpːiˌkɑuris
alta	Noun	ˈal.tə
altis	Adjective	ˈɑltis
altistaa	Verb	ˈɑltistɑː(ʔ)
altistua	Verb	ˈɑl̪t̪istu.ɑˣ
altistus	Noun	ˈɑltistus
alttari	Noun	ˈɑltːɑri
alue	Noun	ˈɑlue̞ˣ
aluke	Noun	ˈɑluke̞ˣ
alumiini	Noun	ˈɑluˌmiːni
alumiinifolio	Noun	ˈɑlumiːniˌfolio
aluminoida	Verb	ˈɑluminoidɑ(ʔ)
aluna	Noun	ˈɑlunɑ
alus	Noun	ˈɑlus
aluskasvillisuus	Noun	ˈɑlusˌkɑsʋilːisuːs
aluslehti	Noun	ˈɑlusˌlehti
alusvaate	Noun	ˈɑlusˌʋɑːtːeːt
alvejuuri	Noun	ˈɑlʋeʔˌjuːri
amalgaamipaikka	Noun	ˈɑmɑlɡɑːmiˌpɑikːɑ
amarantti	Noun	ˈɑmɑˌrɑntːi
amazoninmanaatti	Noun	ˈɑmɑtsoniˌmːɑnɑːtːi
ambitio	Noun	ˈɑmbitio
ameba	Noun	əˈmiːbə
ametisti	Noun	ˈɑmetisti
amfetamiini	Noun	ˈɑɱfetɑmiːni
ammatti	Noun	ˈɑmːɑtːi
ammattikalastaja	Noun	ˈɑmːɑtːiˌkɑlɑstɑjɑ
ammattimaisesti	Adverb	ˈɑmːɑt̪ːiˌmɑise̞sti
ammattiosasto	Noun	ˈɑmːɑtːiˌosɑsto
amme	Noun	ˈɑmːeˣ
ammoinen	Adjective	ˈɑmːo̞ine̞n
ammoniakkihiippo	Noun	ˈɑmːoniɑkːiˌhiːpːo
ammu	Verb	ˈɑmːu(ʔ)
ammuimme	Verb	ˈɑmːuimːe
ammuin	Verb	ˈɑmːuin
ammuit	Verb	ˈɑmːuit
ammuitte	Verb	ˈɑmːuitːe
ammumme	Verb	ˈɑmːumːe
ammut	Verb	ˈɑmːut
ammuttaessa	Verb	ˈɑmːutːɑesːɑ
ammuttaman	Verb	ˈɑmːutːɑmɑn
ammuttava	Verb	ˈɑmːutːɑvɑ
ammutte	Verb	ˈɑmːutːe
ammuttua	Verb	ˈɑmːutːuɑ
ammuttuihin	Verb	ˈɑmːutːuihin
ammuttuina	Verb	ˈɑmːutːuinɑ
ammuttuine	Verb	ˈɑmːutːuine
ammuttuja	Verb	ˈɑmːutːujɑ
ammuttujen	Verb	ˈɑmːutːujen
ammuttuna	Verb	ˈɑmːutːunɑ
ammuttuun	Verb	ˈɑmːutːuːn
ammutuiksi	Verb	ˈɑmːutuiksi
ammutuilla	Verb	ˈɑmːutuilːɑ
ammutuille	Verb	ˈɑmːutuilːe(ʔ)
ammutuilta	Verb	ˈɑmːutuiltɑ
ammutuin	Verb	ˈɑmːutuin
ammutuissa	Verb	ˈɑmːutuisːɑ
ammutuista	Verb	ˈɑmːutuistɑ
ammutuitta	Verb	ˈɑmːuˌtuitːɑ
ammutuksi	Verb	ˈɑmːutuksi
ammutulla	Verb	ˈɑmːutulːɑ
ammutulle	Verb	ˈɑmːutulːe(ʔ)
ammutulta	Verb	ˈɑmːutultɑ
ammutun	Verb	ˈɑmːutun
ammutussa	Verb	ˈɑmːutusːɑ
ammutusta	Verb	ˈɑmːutustɑ
ammutut	Verb	ˈɑmːutut
ammututta	Verb	ˈɑmːututːɑ
ampakiini	Noun	ˈɑmpɑkiːni
ampiainen	Noun	ˈɑmpiɑine̞n
amplitudi	Noun	ˈɑmplitudi
amplitudimodulaatio	Noun	ˈɑmplitudiˌmodulɑːtio
amppari	Noun	ˈɑmpːɑri
ampua	Verb	ˈɑmpuɑˣ
ampuakseen	Verb	ˈɑmpuɑkˌseni
ampuen	Verb	ˈɑmpuen
ampuessa	Verb	ˈɑmpuesːɑ
ampui	Verb	ˈɑmpui
ampuivat	Verb	ˈɑmpuivɑt
ampulli	Noun	ˈɑmpulːi
ampumaan	Verb	ˈɑmpumɑːn
ampumaisillaan	Verb	ˈɑmpumɑiˌsilːɑni
ampumalla	Verb	ˈɑmpumɑlːɑ
ampuman	Verb	ˈɑmpumɑn
ampumarata	Noun	ˈɑmpumɑˌrɑtɑ
ampumassa	Verb	ˈɑmpumɑsːɑ
ampumasta	Verb	ˈɑmpumɑstɑ
ampumatta	Verb	ˈɑmpumɑtːɑ
ampuminen	Noun	ˈɑmpuminen
ampuneeksi	Verb	ˈɑmpuneːksi
ampuneella	Verb	ˈɑmpuneːlːɑ
ampuneelle	Verb	ˈɑmpuneːlːe(ʔ)
ampuneelta	Verb	ˈɑmpuneːltɑ
ampuneen	Verb	ˈɑmpuneːn
ampuneena	Verb	ˈɑmpuneːnɑ
ampuneeseen	Verb	ˈɑmpuneːseːn
ampuneessa	Verb	ˈɑmpuneːsːɑ
ampuneesta	Verb	ˈɑmpuneːstɑ
ampuneet	Verb	ˈɑmpuneːt
ampuneetta	Verb	ˈɑmpuneːtːɑ
ampuneiden	Participle	ˈɑmpuˌneiden
ampuneiksi	Verb	ˈɑmpuneiksi
ampuneilla	Verb	ˈɑmpuneilːɑ
ampuneille	Verb	ˈɑmpuneilːe(ʔ)
ampuneilta	Verb	ˈɑmpuneiltɑ
ampunein	Verb	ˈɑmpunein
ampuneina	Verb	ˈɑmpuneinɑ
ampuneine	Verb	ˈɑmpuneine
ampuneisiin	Verb	ˈɑmpuneisiːn
ampuneissa	Verb	ˈɑmpuneisːɑ
ampuneista	Verb	ˈɑmpuneistɑ
ampuneita	Verb	ˈɑmpuneitɑ
ampuneitta	Verb	ˈɑmpuneitːɑ
ampunut	Verb	ˈɑmpunut
ampunutta	Verb	ˈɑmpunutːɑ
amput	Verb	ˈɑmput
amputaatio	Noun	ˈɑmpuˌt̪ɑːt̪io̞
amputointi	Noun	ˈɑmpuˌt̪o̞in̪t̪i
ampuu	Verb	ˈɑmpuː
ampuva	Verb	ˈɑmpuvɑ
ampuvat	Verb	ˈɑmpuvɑt
amurinleopardi	Noun	ˈɑmurinˌleopɑrdi
anafylaksia	Noun	ˈɑnɑfylɑksiɑ
anafylaktinen	Adjective	ˈɑnɑfylɑktinen
anagrammi	Noun	ˈɑnɑɡrɑmːi
analfabeetti	Noun	ˈɑnɑlfɑbeːtːi
analysoida	Verb	ˈɑnɑlysoidɑ(ʔ)
analysointi	Noun	ˈɑnɑlyˌsointi
anamneesi	Noun	ˈɑnɑmne̞ːsi
anarkia	Noun	ˈɑnɑrkiɑ
anastaa	Verb	ˈɑnɑstɑː(ʔ)
androgynia	Noun	ˈɑndroɡyniɑ
anella	Noun	ˈɑne̞lːɑˣ
anestesia	Noun	ˈɑnestesiɑ
aneurysma	Noun	ˈɑne̞urysmɑ
angiina	Noun	ˈɑŋːiːnɑ
anglosaksi	Noun	ˈɑŋloˌsɑksi
animoida	Verb	ˈɑnimoidɑ(ʔ)
anioni	Noun	ˈɑnioni
anis	Noun	ˈɑnis
anismalikka	Noun	ˈɑnisˌmɑlikːɑ
ankara	Adjective	ˈɑŋkɑrɑ
ankarahalla	Noun	ˈɑŋkɑrɑ ˈhɑlːɑ
ankerias	Noun	ˈɑŋke̞riɑs
ankka	Noun	ˈɑŋkːɑ
ankkalinnalainen	Noun	ˈɑŋkːɑlinːɑlɑi̯nen
ankkuroida	Verb	ˈɑŋkːuroidɑ(ʔ)
anna	Noun	ˈænə
annettaneen	Verb	ˈɑnːetːɑneːn
annettava	Verb	ˈɑnːetːɑvɑ
anniskelu	Noun	ˈɑnːiske̞lu
annos	Noun	ˈɑnːos
annosvuoka	Noun	ˈɑnːosˌʋuɔkɑ
anoa	Noun	ˈɑnoɑˣ
anoi	Verb	ˈɑnoi
anon	Adverb	əˈnɒn
anoppi	Noun	ˈɑnopːi
anoppila	Noun	ˈɑno̞pːilɑ
ansa	Noun	ˈɑnsɑ
ansaita	Verb	ˈɑnsɑi̯tɑˣ
ansari	Noun	ˈɑnsɑri
ansastaa	Verb	ˈɑnsɑstɑː(ʔ)
ansio	Noun	ˈɑnsio
ansiokas	Adjective	ˈɑnsio̞kɑs
antaa	Verb	ˈɑntɑːˣ
antaaanteeksi	Verb	ˈɑntɑː(ʔ)ˈɑnteːksi
antagonisti	Noun	ˈɑntɑɡonisti
antaminen	Noun	ˈɑntɑminen
anteeksi	Noun	ˈɑnteːksi
antenni	Noun	ˈɑn̪t̪e̞nːi
antifasismi	Noun	ˈɑntiˌfɑsismi
antigeeni	Noun	ˈɑntiɡeːni
antikvariaatti	Noun	ˈɑntikʋɑriˌɑːtːi
antipatia	Noun	ˈɑn̪t̪ipɑt̪iɑ
antonyymi	Noun	ˈɑntonyːmi
antropologi	Noun	ˈɑntropoloɡi
anus	Noun	ˈeɪ.nəs
aortta	Noun	ˈɑo̞rtːɑ
aorttaläppä	Noun	ˈɑo̞rtːɑˌlæpːæ
ap	Adjective	ˈɑːpe̞ː
apaattinen	Adjective	ˈɑpɑːt̪ːine̞n
apaja	Noun	ˈɑpɑjɑ
apeus	Noun	ˈɑpe̞us
apikaalisilmu	Noun	ˈɑpikɑːliˌsilmu
apila	Noun	ˈɑpilɑ
apina	Noun	ˈɑpinɑ
apinanleipäpuu	Noun	ˈɑpinɑnˌle̞ipæˌpuː
aplodeerata	Verb	ˈɑplodeːrɑtɑ(ʔ)
apokryfi	Noun	ˈɑpokryfi
appellatiivi	Noun	ˈɑpːelːɑtiːʋi
appelsiini	Noun	ˈɑpːelsiːni
appi	Noun	ˈɑpːi
aprikoosi	Noun	ˈɑprikoːsi
aprillipila	Noun	ˈɑprilːiˌpilɑ
aprillipäivä	Noun	ˈɑprilːiˌpæi̯ʋæ
apteekkari	Noun	ˈɑpteːkːɑri
apu	Noun	ˈʔapu
apumies	Noun	ˈɑpuˌmies
apuri	Noun	ˈɑpuri
arabiankahvi	Noun	ˈɑrɑbiɑŋˌkɑħʋi
arbuusi	Noun	ˈɑrbuːsi
areena	Noun	ˈɑreːnɑ
argumentaatio	Noun	ˈɑrɡumentɑːtio
argumentti	Noun	ˈɑrɡumentːi
arho	Noun	ˈɑrxo̞
arinakääpä	Noun	ˈɑrinɑˌkæːpæ
aristaa	Verb	ˈɑristɑː(ʔ)
aristella	Verb	ˈɑristelːɑ(ʔ)
aristellen	Verb	ˈɑristelːen
aristokraatti	Noun	ˈɑristoˌkrɑːtːi
arka	Adjective	ˈɑrkɑ
arkailla	Verb	ˈɑrkɑilːɑ(ʔ)
arkaillen	Verb	ˈɑrkɑilːen
arkaismi	Noun	ˈɑrkɑˌismi
arkebuusi	Noun	ˈɑrkeˌbuːsi
arkeologi	Noun	ˈɑrkeoloɡi
arkipyhä	Noun	ˈɑrkiˌpyɦæ
arkipäivä	Noun	ˈɑrkiˌpæi̯ʋæ
arkisto	Noun	ˈɑrkisto̞
arkistointi	Noun	ˈɑrkisto̞in̪t̪i
arkkitehtuuri	Noun	ˈɑrkːitehtuːri
arkuus	Noun	ˈɑrkuːs
armahtaa	Verb	ˈɑrmɑhtɑː(ʔ)
armas	Verb	ˈarmas
armeija	Noun	ˈɑrmeijːɑ
armenia	Noun	ˈɑrmeniɑ
armenialainen	Adjective	ˈɑrmeniɑˌlɑinen
armokuolema	Noun	ˈɑrmoˌkuolemɑ
armomurha	Noun	ˈɑrmoˌmurɦɑ
armoton	Noun	ˈɑrmo̞t̪o̞n
aromi	Verb	ˈɑro̞mi
aromikas	Adjective	ˈɑro̞mikas
arominvahvenne	Noun	ˈɑro̞miˌʋɑxʋenːe̞ˣ
arpa	Noun	ˈaɾ.pə
arpakuutio	Noun	ˈɑrpɑˌkuːt̪io̞
arsenaali	Noun	ˈɑrsenɑːli
artikla	Noun	ˈɑrtiklɑ
artikulaatio	Noun	ˈɑrtikulɑːtio
arvailla	Verb	ˈɑrʋɑilːɑ(ʔ)
arvata	Verb	ˈɑrʋɑtɑ(ʔ)
arvella	Noun	ˈɑrʋelːɑ
arvellen	Verb	ˈɑrvelːen
arvelu	Noun	ˈɑrʋe̞lu
arveluttaa	Verb	ˈɑrvelutːɑː(ʔ)
arvio	Noun	ˈɑrvio
arvioida	Verb	ˈɑrvioidɑ(ʔ)
arvoituksellinen	Adjective	ˈɑrʋo̞it̪ukse̞lːine̞n
arvoitus	Noun	ˈɑrʋoitus
arvokas	Adjective	ˈɑrʋo̞kɑs
arvonlisävero	Noun	ˈɑrʋonˌlisæˌʋero
arvonta	Noun	ˈɑrʋo̞n̪t̪ɑ
arvosana	Noun	ˈɑrʋo̞ˌsɑnɑ
arvoton	Adjective	ˈɑrʋo̞t̪o̞n
asbesti	Noun	ˈɑsbesti
ase	Verb	ˈɑse̞ˣ
aseapu	Noun	ˈɑseʔːˌɑpu
aseenkantolupa	Noun	ˈɑseːŋˌkɑntoˌlupɑ
aseenkäsittely	Noun	ˈɑseːŋˌkæsitːely
aseettomuus	Noun	ˈɑseːtːomuːs
aseidentuonti	Noun	ˈɑseidenˌtuɔnti
aseidenvienti	Noun	ˈɑseidenˌʋienti
aseistaa	Verb	ˈɑseistɑː(ʔ)
aseistakieltäytyjä	Noun	ˈɑseistɑˌkieltæytyjæ
aseistautua	Verb	ˈɑseistɑuˌt̪uɑ(ʔ)
asekauppa	Noun	ˈɑseˌkːɑu̯pːɑ
aselepolinja	Noun	ˈɑseˌlːepoˌlinjɑ
asema	Noun	ˈɑsemɑ
asento	Noun	ˈɑsento
asentoaisti	Noun	ˈɑsentoˌɑisti
asepalvelus	Noun	ˈɑseˌpːɑlvelus
asete	Noun	ˈɑse̞t̪e̞ˣ
asettaa	Verb	ˈɑsetːɑː(ʔ)
asettua	Verb	ˈɑse̞t̪ːu.ɑ
asetus	Noun	ˈɑsetus
asevarustelu	Noun	ˈɑseˌʋːɑrustelu
asevelvollisuus	Noun	ˈɑseˌʋːelʋolːisuːs
asfaltti	Noun	ˈɑsfɑltːi
asfalttiihottuma	Noun	ˈɑsfɑltːiʔˌiɦotːumɑ
asia	Noun	ˈɑsiɑ
asiaankuuluva	Adjective	ˈɑsiɑːŋˌkuːluʋɑ
asiakas	Noun	ˈɑsiɑkɑs
asiakaspalvelu	Noun	ˈɑsiɑkɑsˌpɑlʋelu
asiantunteva	Adjective	ˈɑsiɑnˌt̪un̪t̪e̞ʋɑ
asiantuntija	Noun	ˈɑsiɑnˌt̪un̪t̪ijɑ
asiaton	Adjective	ˈɑsiɑton
asioida	Verb	ˈɑsioidɑ(ʔ)
asioita	Noun	ˈɑsioitɑ
askare	Noun	ˈɑskɑreˣ
askarruttaa	Verb	ˈɑskɑrːut̪ːɑːˣ
askelfunktio	Noun	ˈɑske̞lˌfuŋkt̪io̞
askelittain	Adverb	ˈɑskeˌlitːɑi̯n
askelmoottori	Noun	ˈɑske̞lˌmo̞ːt̪ːo̞ri
askelpalautin	Noun	ˈɑskelˌpɑlɑutin
aski	Noun	ˈɑski
aspartaami	Noun	ˈɑspɑrtɑːmi
assimiloida	Verb	ˈɑsːimiloidɑ(ʔ)
assimiloitua	Verb	ˈɑsːimiloi̯tuɑˣ
aste	Noun	ˈas̺.te
asteittainen	Adjective	ˈɑste̞it̪ːɑine̞n
astella	Verb	ˈɑste̞lːɑˣ
astemitta	Noun	ˈɑsteˌmːitːɑ
asteriski	Noun	ˈɑsteriski
asteroidi	Noun	ˈɑsteˌroidi
asteroidivyöhyke	Noun	ˈɑste̞ro̞idiˌʋyøɦyke̞ˣ
astianpesukone	Noun	ˈɑstiɑnˌpesuˌkoneˣ
astimen	Noun	ˈɑstimen
astin	Noun	ˈɑstin
astrokemia	Noun	ˈɑstroˌkemiɑ
astrometria	Noun	ˈɑstroˌmetriɑ
astronautti	Noun	ˈɑstronɑutːi
astua	Verb	ˈɑstuɑ(ʔ)
astuttaa	Verb	ˈɑstutːɑː(ʔ)
asu	Noun	ˈɑsu
asua	Noun	ˈɑsu.ɑ
asukaspuisto	Noun	ˈasukasˌpuisto
asukastiheys	Noun	ˈɑsukɑsˌtiɦeys
asuntola	Noun	ˈɑsun̪t̪o̞lɑ
asuntovaunu	Noun	ˈɑsuntoˌʋɑunu
asuste	Noun	ˈɑsuste̞ˣ
asuttaa	Verb	ˈɑsutːɑː(ʔ)
asutuskeskus	Noun	ˈɑsutusˌkeskus
asvalttiihottuma	Noun	ˈɑsʋɑltːiʔˌiɦotːumɑ
ateismi	Noun	ˈɑteismi
ateljee	Noun	ˈɑteljeː
atleetti	Noun	ˈɑtleːtːi
atmerkki	Noun	ˈætˌmerkːi
atomikello	Noun	ˈɑtomiˌkelːo
atria	Noun	ˈɑtriɑ
attosekunti	Noun	ˈɑtːosekunti
attribuutti	Noun	ˈɑtːribuːtːi
audienssi	Noun	ˈɑudiensːi
audiofiili	Noun	ˈɑudioˌfiːli
auervaara	Noun	ˈɑuerˌʋɑːrɑ
aueta	Verb	ˈɑuetɑˣ
aukea	Adjective	ˈɑukeɑ
auki	Adverb	ˈɑu̯ki
aukko	Noun	ˈɑu̯kːo
aula	Noun	ˈɔːla
aulio	Noun	ˈɑulio̞
auma	Noun	ˈɑumɑ
aura	Noun	ˈɑu̯rɑ
aurata	Verb	ˈɑurɑt̪ɑ(ʔ)
auringonjumala	Noun	ˈɑuriŋːo̞nˌjumɑlɑ
auringonpimennys	Noun	ˈɑuriŋːomˌpimenːys
auringonpistos	Noun	ˈɑuriŋːonˌpistos
auringonsuojavoide	Noun	ˈɑuriŋːo̞nˌsuɔjɑˌʋoi̞de̞ˣ
auringonvarjo	Noun	ˈɑuriŋːo̞nˌʋɑrjo̞
aurinko	Noun	ˈɑu̯riŋko
aurinkoenergia	Noun	ˈɑuriŋko̞ˌe̞ne̞rɡiɑ
aurinkokansi	Noun	ˈɑuriŋkoˌkɑnsi
aurinkokenno	Noun	ˈɑuriŋko̞ˌke̞nːo̞
aurinkokylpy	Noun	ˈɑuriŋkoˌkylpy
aurinkopaneeli	Noun	ˈɑuriŋkoˌpɑneːli
aurinkosuoja	Noun	ˈɑuriŋkoˌsuojɑ
australianpähkinä	Noun	ˈɑustrɑliɑmˌpæçkinæ
australiansotka	Noun	ˈɑustrɑliɑnˌsotkɑ
autio	Adjective	ˈɑut̪io̞
auto	Adjective	ˈɔtoʊ
autoilla	Noun	ˈɑut̪o̞ilːɑ
autoistua	Verb	ˈɑutoistuɑ(ʔ)
autolla	Noun	ˈɑutolːɑ
autonomia	Noun	ˈɑut̪oˌnomiɑ
autonrengas	Noun	ˈɑut̪o̞nˌre̞ŋːɑs
autonrämä	Noun	ˈɑutonˌræmæ
autotehdas	Noun	ˈɑut̪o̞ˌt̪e̞çdɑs
auttaa	Verb	ˈɑu̯tːɑːˣ
avainkehys	Noun	ˈɑʋɑin̪ˌke̞ɦys
avainlaji	Noun	ˈɑʋɑinˌlɑji
avainärsyke	Noun	ˈɑʋɑinˌærsyke(ʔ)
avantgardisti	Noun	ˈɑʋɑntɡɑrdisti
avanto	Noun	ˈɑʋɑn̪t̪o̞
avantosukellus	Noun	ˈɑʋɑntoˌsukelːus
avara	Adjective	aˈvara
avaruus	Noun	ˈɑʋɑruːs
avaruuslentäjä	Noun	ˈɑʋɑruːsˌlentæjæ
avaruustiede	Noun	ˈɑʋɑruːsˌtie̞de̞ˣ
avata	Verb	ˈɑʋɑt̪ɑ(ʔ)
avautua	Verb	ˈɑʋɑutuɑ(ʔ)
avec	Noun	ˈɑʋek
avidiini	Noun	ˈɑvidiːni
aviisi	Noun	ˈɑʋiːsi
avittaa	Verb	ˈɑvitːɑː(ʔ)
avomeri	Noun	ˈɑʋoˌmeri
avomies	Noun	ˈɑʋoˌmies
avomurtuma	Noun	ˈɑʋoˌmurtumɑ
avovaimo	Noun	ˈɑʋoˌʋɑimo
avustaa	Verb	ˈɑvustɑː(ʔ)
avväline	Noun	ˈɑːʋe̞ːˌʋæline̞
chipata	Verb	ˈtʃipɑtɑ
chowchow	Noun	ˈt̪so̞uˌt̪so̞u
ciabatta	Noun	tʃəˈbɑː.ta
cirrus	Noun	ˈsɪɹəs
cloisonné	Noun	ˈkloɑsonːeː
clou	Noun	ˈkluː
cocktail	Noun	ˈkɔkteːl
college	Noun	ˈkɒlɪd͡ʒ
collegepusero	Noun	ˈko̞lidsˌpuse̞ro̞
comeback	Noun	ˈkʌmbæk
continuum	Noun	kənˈtɪnjuəm
copy	Noun	ˈkɒpi
coulombi	Noun	ˈkulombi
country	Noun	ˈkʌntɹi
coupé	Noun	kuːpeɪ
couscous	Noun	ˈkʊs.kʊs
cover	Noun	ˈkʌvɚ
coverbändi	Noun	ˈko̞ʋe̞rbæŋdi
coverversio	Noun	ˈko̞ʋe̞rˌʋe̞rsio̞
cowboy	Noun	ˈkaʊˌbɔɪ
crack	Verb	kɹæk
croissant	Noun	ˈkɹwæsɒ̃
cumulus	Noun	ˈkjuːmjələs
cup	Noun	kʌp
curling	Noun	ˈkəɹlɪŋ
ellen	Noun	ˈelːen
elliptisyys	Noun	ˈe̞lːipt̪isyːs
elo	Noun	ˈelo
elohopea	Noun	ˈeloˌhopeɑ
elohopeamillimetri	Noun	ˈeloˌhopeɑˌmilːiˌmetri
elokuva	Noun	ˈeloˌkuʋɑ
elokuvalippu	Noun	ˈe̞lo̞ˌkuʋɑˌlipːu
elokuvaohjaaja	Noun	ˈe̞lo̞kuʋɑˌo̞xjɑːjɑ
elonkorjaaja	Noun	ˈeloŋˌkorjɑːjɑ
elonkorjuu	Noun	ˈe̞lo̞ŋˌko̞rjuː
elonkorjuukone	Noun	ˈeloŋˌkorjuːˌkoneˣ
elonmerkki	Noun	ˈelonˌmerkːi
elosalama	Noun	ˈeloˌsɑlɑmɑ
elpyä	Verb	ˈelpyæ(ʔ)
elvistellä	Verb	ˈelʋistelːæˣ
elvyttää	Verb	ˈelvytːæː(ʔ)
elvytys	Noun	ˈelʋytys
eläimellinen	Adjective	ˈe̞læiˌme̞lːinen
eläin	Noun	ˈe̞læ͡in
eläinaktivismi	Noun	ˈelæinˌɑktiʋismi
eläinfysiologia	Noun	ˈelæinˌfysioloɡiɑ
eläinkauppa	Noun	ˈelæi̯nˌkɑu̯pːɑ
eläinkoe	Noun	ˈe̞læinko̞.e̞
eläinlaji	Noun	ˈelæinˌlɑji
eläinlääketiede	Noun	ˈe̞læinˌlæːke̞ˌtː̪ie̞de̞(ʔ)
eläinlääkäri	Noun	ˈelæinˌlæːkæri
eläinmaailma	Noun	ˈelæinˌmɑːilmɑ
eläinoikeusliike	Noun	ˈe̞læin̪ˌo̞ike̞usˌliːke̞(ʔ)
eläinplankton	Noun	ˈelæinˌplɑŋkton
eläinpsykologia	Noun	ˈelæimˌpsykoloɡiɑ
eläinrääkkäys	Noun	ˈelæinˌræːkːæys
eläinsuojelu	Noun	ˈelæinˌsuojelu
eläintenpalvonta	Noun	ˈelæintenˌpɑlʋontɑ
eläke	Noun	ˈe̞læke̞ˣ
eläkeikä	Noun	ˈe̞læk̟e̞(ʔ)ˌik̟æ
elämänkatsomustieto	Noun	ˈe̞læmænˌkɑt̪so̞musˌt̪ie̞t̪o̞
elämäntapa	Noun	ˈelæmænˌtɑpɑ
elätti	Noun	ˈelætːi
elää	Verb	ˈe̞læː(ʔ)
emakko	Noun	ˈemɑkːo
embryologi	Noun	ˈembryoloɡi
emeritusprofessori	Noun	e̞me̞ˈriːtːusˌpro̞fe̞sːo̞ri
emissioida	Verb	ˈemisːioidɑ(ʔ)
emitoida	Verb	ˈemitoidɑ(ʔ)
emittoida	Verb	ˈemitːoidɑ(ʔ)
emiö	Noun	ˈemiø
emme	Noun	ˈemːe
emoalus	Noun	ˈemoˌɑlus
emoji	Noun	ɪˈməʊdʒi
emolevy	Noun	ˈe̞mo̞ˌle̞ʋy
emoyhtiö	Noun	ˈemoˌyxtiø
empiä	Verb	ˈempi.æˣ
emäksinen	Adjective	ˈe̞mæksine̞n
emäksisyys	Noun	ˈe̞mæksisyːs
emäntä	Noun	ˈe̞mæn̪t̪æ
emäs	Noun	ˈe̞mæs
en	Noun	ɛn
enemmistöhallitus	Noun	ˈenemːistøˌhɑlːitus
enetä	Verb	ˈenetæ(ʔ)
engelsmanni	Noun	ˈeŋːelsmɑnːi
englanninsinililja	Noun	ˈeŋlɑnninsinililjɑ
englannintaa	Verb	ˈeŋlɑnːintɑː(ʔ)
englantilainen	Adjective	ˈeŋlɑntilɑinen
enintään	Adverb	ˈenintæːn
eniten	Adverb	e̞nit̪e̞n
enkeli	Noun	ˈe̞ŋke̞li
enkku	Noun	ˈeŋkːu
ennakkoasenne	Noun	ˈe̞nːɑkːo̞ˌɑse̞nːe̞ˣ
ennakkopäätös	Noun	ˈenːɑkːoˌpæːtøs
ennakkoratkaisu	Noun	ˈenːɑkːoˌrɑtkɑisu
ennakkotapaus	Noun	ˈenːɑkːoˌtɑpɑus
ennakointi	Noun	ˈenːɑkointi
enne	Noun	ˈenːe
ennen	Adverb	ˈe̞nːe̞n
ennustaa	Verb	ˈenːustɑː(ʔ)
ennuste	Noun	ˈenːuste(ʔ)
ennustus	Noun	ˈe̞nːustus
ennättää	Verb	ˈenːætːæː(ʔ)
ennätysaika	Noun	ˈe̞n̪ːæt̪ysˌɑikɑ
ensiesitys	Noun	ˈensiˌesitys
ensihoitaja	Noun	ˈensiˌxoitɑjɑ
ensiilta	Noun	ˈensi(ʔ)ˌiltɑ
ensimmäinen	Adjective	ˈensimːæi̯nen
ensimmäinenmaailmansota	Noun	ˈensimːæinemˈmɑːilmɑnˌsotɑ
ensin	Preposition	ˈe̞nsin
ensipäivänkuori	Noun	ˈensiˌpæiʋænˌkuori
ensirakkaus	Noun	ˈensiˌrɑkːɑus
ensivaikutelma	Noun	ˈensiˌʋɑikutelmɑ
ensiökäämi	Noun	ˈensiøˌkæːmi
enteillä	Noun	ˈe̞n̪t̪e̞ilːæ
entisöidä	Verb	ˈe̞n̪t̪isø̞idæˣ
entisöinti	Noun	ˈentisøinti
entä	Conjunction	ˈe̞n̪t̪æ
enää	Adverb	ˈe̞næː
eoni	Noun	ˈeoni
eoseeni	Noun	ˈeoseːni
epatto	Noun	ˈepɑt̪ːo̞
epidermi	Noun	ˈepidermi
epiduraalipuudutus	Noun	ˈepidurɑːliˌpuːdutus
epilepsiakohtaus	Noun	ˈepilepsiɑˌkohtɑus
epiteeli	Noun	ˈepiteːli
epookki	Noun	ˈepoːkːi
eppu	Noun	ˈe̞pːu
epsilon	Noun	ɛpˈsaɪ.lən
epä	Prefix	ˈepæ
epäilevä	Adjective	ˈepæilevæ
epäilevätuomas	Noun	ˈepæilevæ ˈtuomɑs
epäillä	Verb	ˈepæilːæ(ʔ)
epäilys	Noun	ˈepæilys
epäilyttää	Verb	ˈepæilytːæː(ʔ)
epäitsekkyys	Noun	ˈe̞pæˌit̪se̞kːyːs
epäitsekäs	Adjective	ˈe̞pæˌit̪se̞kæs
epäjumala	Noun	ˈe̞pæˌjumɑlɑ
epäjärjestelmällistyttämättömyydellänsäkään	Noun	ˈe.pæ.jær.jes.tel.mælː.is.tytː.æ.mætː.øˌmyː.delː.æn.sæ.kæːn
epämiehekäs	Adjective	ˈe̞pæˌmie̞ɦe̞kæs
epäpoliittinen	Noun	ˈepæˌpoliːtːinen
epäröimättä	Adverb	ˈepærøi̯mætːæ
epäröinti	Noun	ˈepærøinti
epätasapaino	Noun	ˈepæˌtɑsɑˌpɑino
epätäsmällisyys	Noun	ˈepæˌtæsmæˌlːisyːs
epävakaa	Adjective	ˈe̞pæˌʋɑkɑː
epävapaa	Adjective	ˈe̞pæˌʋɑpɑː
erakko	Noun	ˈerɑkːo
erakoitua	Verb	ˈe̞rɑko̞it̪uɑˣ
eranto	Noun	ˈerɑnto
erikoinen	Adjective	ˈerikoinen
erikoismerkki	Noun	ˈerikoisˌmerkːi
erikoistua	Verb	ˈerikoistuɑ(ʔ)
erilainen	Adjective	ˈeriˌlːɑinen
erilaisitiöisyys	Noun	ˈerilːɑisˌitiøisyːs
erilaiskehäinen	Adjective	ˈerilːɑisˌkeɦæinen
erilaislehtisyys	Noun	ˈerilɑisˌlehtisyːs
erilaissekovartisuus	Noun	ˈerilɑisˌsekoʋɑrtisuːs
erillisemisyys	Noun	ˈerilːisˌemisyːs
eriste	Noun	ˈe̞riste̞ˣ
eristää	Verb	ˈeristæː(ʔ)
eritellä	Verb	ˈeritelːæ(ʔ)
erittyä	Verb	ˈeritːyæ(ʔ)
erittää	Verb	ˈeritːæː(ʔ)
erkaantua	Verb	ˈe̞rkɑːn̪t̪uɑˣ
erkanee	Verb	ˈerkɑneː
erkanen	Verb	ˈerkɑnen
erkanet	Verb	ˈerkɑnet
erkkeri	Noun	ˈerkːeri
ero	Noun	ˈero
eroamaan	Verb	ˈeroɑmɑːn
eronto	Noun	ˈeronto
erota	Verb	ˈerotɑˣ
erämaaalue	Noun	ˈeræˌmɑː(ʔ)ˌɑlue(ʔ)
eräreitti	Noun	ˈeræˌreitːi
erääntyä	Verb	ˈeræːntyæ(ʔ)
esi	Prefix	ˈesi
esiintyä	Verb	ˈesiːntyæ(ʔ)
esikoulu	Noun	ˈe̞siˌko̞ulu
esikuva	Noun	ˈesiˌkuʋɑ
esimies	Noun	ˈesiˌmies
esine	Noun	ˈe̞sine̞ˣ
esineellistää	Verb	ˈe̞sine̞ːlːistæːˣ
esipuhe	Noun	ˈe̞siˌpuɦe̞ˣ
esite	Noun	ˈe̞sit̪e̞ˣ
esitellä	Verb	ˈesitelːæ(ʔ)
esittäytyä	Verb	ˈesitːæytyæ(ʔ)
esittää	Verb	ˈesitːæː(ʔ)
esityksellinen	Adjective	ˈe̞sit̪ykse̞lːine̞n
esitys	Noun	ˈe̞sit̪ys
eskaloida	Verb	ˈeskɑloidɑ(ʔ)
eskaloitua	Verb	ˈeskɑloituɑ(ʔ)
eskari	Noun	ˈeskɑri
eskimo	Noun	εsɡ̊iˈmoːˀ
eskimosirri	Noun	ˈeskimoˌsirːi
espanjatar	Noun	ˈespɑnjɑtɑr
essee	Noun	ˈesːeː
essi	Noun	ˈesːi
esso	Noun	əsso
este	Noun	ˈesteˣ
esteellinen	Adjective	ˈesteːlːinen
esteellisyys	Noun	ˈesteːlːisyːs
esteellisyysperuste	Noun	ˈesteːlːisyːsˌperuste(ʔ)
esteettömyys	Noun	ˈesteːtːømyːs
estejuoksu	Noun	ˈe̞ste̞ˌjːuɔksu
esteri	Noun	ˈesteri
et	Conjunction	ɛt
etaani	Noun	ˈetɑːni
etana	Noun	ˈeˑt̪ɑˑnɑ
etappi	Noun	ˈetɑpːi
eteeni	Noun	ˈeteːni
eteinen	Noun	ˈeteinen
eteisvärinä	Noun	ˈeteisˌʋærinæ
etelä	Noun	ˈetelæ
etevä	Adjective	ˈeteʋæ
etiketti	Noun	ˈetiketːi
etikkaeetteri	Noun	ˈetikːɑˌeːtːeri
etpä	Verb	ˈetpæ
etruski	Noun	ˈetruski
etsata	Verb	ˈe̞t̪sɑt̪ɑ(ʔ)
etsin	Noun	ˈe̞t̪sin
etsintä	Noun	ˈetsintæ
ette	Noun	ˈetːe
etu	Noun	ˈe̞t̪u
etukäteen	Adverb	ˈetukæteːn
etuliite	Noun	ˈetuˌliːte
etumainen	Adjective	ˈe̞t̪umɑine̞n
etuovi	Noun	ˈetuˌoʋi
eturauhanen	Noun	ˈetuˌrɑuɦɑnen
eturauhastulehdus	Noun	ˈeturɑuɦɑsˌtulehdus
eturistiriita	Noun	ˈetuˌristiriːtɑ
eturivi	Noun	ˈetuˌriʋi
etuseteli	Noun	ˈe̞t̪uˌse̞t̪e̞li
etuvokaali	Noun	ˈetuˌʋokɑːli
etyylialkoholi	Noun	ˈe̞t̪yːliˌɑlko̞ɦo̞li
etäinen	Adjective	ˈetæinen
etäispesäke	Noun	ˈetæisˌpesæke(ʔ)
etäisyys	Noun	ˈetæisyːs
etäpesäke	Noun	ˈetæˌpesæke(ʔ)
etätyö	Noun	ˈe̞t̪æˌt̪yø̞
etääntyä	Verb	ˈe̞t̪æːn̪t̪yæˣ
euforia	Noun	ˈeuforiɑ
euro	Prefix	ˈe̞uro̞
eurokraatti	Noun	ˈeuroˌkrɑːtːi
euroviisu	Noun	ˈeuroˌʋiːsu
evakko	Noun	ˈeʋɑkːo
evakuointi	Noun	ˈe̞ʋɑku.o͡in̪t̪i
evergreen	Adjective	ˈɛvəɡɹiːn
evidenssi	Noun	ˈe̞ʋide̞nsːi
eväste	Noun	ˈe̞ʋæst̪e̞ˣ
evätä	Verb	ˈeʋætæ(ʔ)
grönlanti	Noun	ˈɡrøːnlɑn̪t̪i
guassi	Noun	ˈɡuɑsːi
guassiväri	Noun	ˈɡuɑsːiˌʋæri
gurut	Noun	ˈɡurut̪
hatuntekijä	Noun	ˈhɑtunˌtekijæ
haudata	Verb	ˈhɑudɑtɑ(ʔ)
hauis	Noun	ˈhɑuis
haukahdella	Verb	ˈhɑukɑxˌde̞lːɑˣ
haukahtaa	Verb	ˈhɑukɑhtːɑ(ʔ)
hauki	Noun	ˈhɑu̯ki
haukkua	Verb	ˈhɑukːuɑ(ʔ)
haukkuamaanrakoon	Verb	ˈhɑukːuɑ ˈmːɑːnˌrɑkoːn
haukkuapataluhaksi	Verb	ˈhɑukːuɑˣ ˈpːɑtɑˌluhɑksi
haukkuapystyyn	Verb	ˈhɑukːuɑ ˈpːystyːn
haukotella	Verb	ˈhɑukotelːɑˣ
haukottelu	Noun	ˈhɑukotːelu
haukotus	Noun	ˈhɑukotus
hauli	Noun	ˈhɑuli
haupitsi	Noun	ˈhɑupitsi
hauraus	Noun	ˈhɑurɑus
hautajaiset	Noun	ˈhɑutɑˌjɑiset
hauva	Noun	hɑuʋːɑ
havaitsemme	Verb	ˈhɑʋɑit̪ˌse̞mːe̞
havas	Verb	ˈhɑʋɑs
havumetsä	Noun	ˈhɑʋuˌmetsæ
havununna	Noun	ˈhɑʋuˌnunːɑ
havupuu	Noun	ˈhɑʋuˌpuː
he	Pronoun	ˈhiː
hede	Noun	heːðə
hedelmistö	Noun	ˈhedelmistø
hedelmys	Noun	ˈhedelmys
hedelmä	Noun	ˈhedelmæ
hedelmäkeitto	Noun	ˈhedelmæˌkeitːo
hedelmällisyys	Noun	ˈhedelmælːisyːs
hedelmäsalaatti	Noun	ˈhedelmæˌsɑlɑːtːi
hedelmäsokeri	Noun	ˈhedelmæˌsokeri
hedelmäveitsi	Noun	ˈhedelmæˌʋeitsi
hedelmöittyä	Verb	ˈhedelmøitːyæ(ʔ)
hedelmöittäminen	Noun	ˈhedelˌmøitːæˌminen
hedelmöittää	Verb	ˈhedelmøitːæː(ʔ)
hedelmöityä	Verb	ˈhedelmøitːyæ(ʔ)
hehku	Noun	ˈhehku
hehkua	Verb	ˈhehkuɑ(ʔ)
hehkulamppu	Noun	ˈhehkuˌlɑmpːu
hehkulanka	Noun	ˈhehkulɑŋkɑ
hehtaari	Noun	ˈhehtɑːri
hei	Noun	ɦɛi̯
heidän	Pronoun	ˈheidæn
heihin	Pronoun	ˈheihin
heijaste	Noun	ˈheijaste(ʔ)
heijastuskulma	Noun	ˈheijɑstusˌkulmɑ
heikentyä	Verb	ˈheikentyæ(ʔ)
heiketä	Verb	ˈheiketæ
heikottaa	Verb	ˈhe̞iko̞t̪ːɑːˣ
heiksi	Pronoun	ˈheiksi
heila	Noun	ˈhei̯lɑ
heille	Pronoun	ˈheilːe(ʔ)
heillä	Pronoun	ˈheilːæ
heiltä	Pronoun	ˈheiltæ
heinä	Noun	ˈheinæ
heinäaro	Noun	ˈheinæˌɑro
heinänuha	Noun	ˈheinæˌnuɦɑ
heinäpelto	Noun	ˈheinæˌpelto
heinäsuova	Noun	ˈheinæˌsuoʋɑ
heinätavi	Noun	ˈheinæˌtɑʋi
heisimato	Noun	ˈheisiˌmɑto
heissä	Pronoun	ˈheisːæ
heistä	Pronoun	ˈheistæ
heitin	Noun	ˈhei̯tin
heittomerkki	Noun	ˈheitːoˌmerkːi
heittovaihtotiedosto	Noun	ˈhe̞it̪ːo̞ˌʋɑiht̪o̞ˌt̪ie̞do̞st̪o̞
heittä	Pronoun	ˈheitːæ
heittää	Verb	ˈhei̯tːæːˣ
heitä	Pronoun	ˈheitæ
hekumaa	Noun	ˈhekumɑː
helatorstai	Noun	ˈhelɑˌtorstɑi̯
hele	Verb	hiːl
helistää	Verb	ˈhe̞listæːˣ
helle	Verb	ˈhelːe(ʔ)
hellitä	Verb	ˈhelːitæˣ
helluntai	Noun	ˈhelːuntɑi̯
helmi	Noun	ˈhe̞lmi
helmiitiö	Noun	ˈhelmi(ʔ)ˌitiø
helmipöllö	Noun	ˈhe̞lmiˌpø̞lːø̞
helmitaulu	Noun	ˈhelmiˌtɑulu
helposti	Adverb	ˈhelposti(ʔ)
helppo	Adjective	ˈhelpːo
helve	Noun	hɛlv
hengata	Verb	ˈhe̞ŋːɑt̪ɑˣ
hengenpelastaja	Noun	ˈheŋːemˌpelɑstɑjɑ
hengenvaara	Noun	ˈheŋːenˌʋɑːrɑ
hengittää	Verb	ˈheŋːitːæ(ʔ)
hengitysharjoitus	Noun	ˈheŋːitysˌhɑrjoitus
hengitysilma	Noun	ˈheŋːitysˌilmɑ
hengityskone	Noun	ˈheŋːitysˌkoneˣ
hengitystie	Noun	ˈheŋːitysˌtie(ʔ)
henkari	Noun	ˈheŋkɑri
henkeen	Noun	ˈheŋkeːn
henkeenjavereen	Adverb	ˈheŋkeːn ˈja ˈvereːn
henkilö	Noun	ˈheŋkilø
henkilökunta	Noun	ˈheŋkiløˌkun̪t̪ɑ
henkilötunnus	Noun	ˈheŋkiløˌtunːus
henkivartija	Noun	ˈheŋkiˌʋɑrtijɑ
henkiä	Noun	ˈhe̞ŋki.æˣ
hento	Adjective	ˈhento
hentosudenkorento	Noun	ˈhentoˌsudeŋˌkorento
hepatoosi	Noun	ˈhepɑˌtoːsi
hepo	Noun	ˈhepo
heprea	Noun	ˈhepreɑ
heprealainen	Adjective	ˈhepreɑˌlɑinen
herjetä	Verb	ˈherjetæ(ʔ)
herkkusieni	Noun	ˈhe̞rkːuˌsie̞ni
herkkutatti	Noun	ˈhe̞rkːuˌt̪ɑt̪ːi
hermo	Noun	ˈhe̞rmo̞
hermoimpulssi	Noun	ˈhermoˌimpulsːi
hermosto	Noun	ˈhe̞rmo̞sto̞
herra	Noun	ˈherːɑ
herran	Noun	ˈherːɑn
hertta	Noun	ˈhertːɑ
herttua	Noun	ˈhe̞rt̪ːuɑ
herukka	Noun	ˈherukːɑ
herätellä	Verb	ˈherætelːæ(ʔ)
herätyskello	Noun	ˈherætysˌkelːo
herätä	Verb	ˈherætæ
het	Noun	hɛt
heteromies	Noun	ˈhe̞t̪e̞ro̞ˌmie̞s
heteroseksuaali	Noun	ˈheteroˌseksuɑːli
hetiö	Noun	ˈhetiø
hetkellinen	Adjective	ˈhetkelːinen
hetki	Noun	ˈhetki
hetula	Noun	ˈhetulɑ
hevi	Noun	ˈheʋi
hevosmuurahainen	Noun	ˈheʋosˌmuːrɑɦɑinen
hevospaarma	Noun	ˈheʋosˌpɑːrmɑ
hiaisin	Noun	ˈhiɑisin
hieho	Noun	ˈhie̞ɦo̞
hiekkaaavikko	Noun	hiekːɑʔˌɑːʋikːo
hiekkaerämaa	Noun	ˈhiekːɑˌeræˌmɑː
hiekkapilvi	Noun	ˈhiekːɑˌpilʋi
hiekkapohja	Noun	ˈhiekːɑˌpoxjɑ
hiekkaranta	Noun	ˈhie̞kːɑˌrɑn̪t̪ɑ
hiekkatörmä	Noun	ˈhiekːɑˌtørmæ
hiekoitin	Noun	ˈhiekoitin
hienontaa	Verb	ˈhienontɑː
hienontua	Verb	ˈhienontuɑ(ʔ)
hieroa	Verb	ˈhieroɑ(ʔ)
hieroglyfi	Noun	ˈhieroɡlyfi
hieronta	Noun	ˈhierontɑ
hiertymä	Noun	ˈhiertymæ
hiertyä	Verb	ˈhiertyæ(ʔ)
hiertää	Verb	ˈhiertæː
hiesu	Noun	ˈç̞iesu
hieta	Noun	hietɑ
hietatokko	Noun	ˈç̞ietɑˌtokːo
hiha	Noun	ˈhiɦɑ
hihhuli	Noun	ˈhihːuli
hihittää	Verb	ˈhihitːæː(ʔ)
hiihdellä	Verb	ˈhiːçde̞lːæˣ
hiihtohissi	Noun	ˈhiːhtoˌhisːi
hiihtokausi	Noun	ˈhiːçtoˌkɑusi
hiihtokilpailu	Noun	ˈhiːçtoˌkilpɑilu
hiihtolatu	Noun	ˈhiːçtoˌlɑtu
hiihtoloma	Noun	ˈhiːhtoˌlomɑ
hiilentuotanto	Noun	ˈhiːlenˌtuɔtɑnto
hiiliatomi	Noun	ˈhiːliˌɑt̪o̞mi
hiilidioksidi	Noun	ˈhiːliˌdioksidi
hiilidioksidipäästö	Noun	ˈhiːliˌdioksidiˌpæːstø
hiililaiva	Noun	ˈhiːliˌlɑiʋɑ
hiilto	Noun	ˈhiːlto
hiipiä	Verb	ˈhiːpi.æˣ
hiirenvirna	Noun	ˈhiːrenˌʋirnɑ
hiiri	Noun	ˈhiːri
hiiribaari	Noun	ˈhiːriˌbɑːri
hiisi	Noun	ˈhiːsi
hiiva	Noun	ˈç̞iːʋɑ
hiki	Noun	ˈhiki
hikipaja	Noun	ˈhikiˌpɑjɑ
hikirauhanen	Noun	ˈhikiˌrɑuɦɑnen
hikka	Noun	ˈhikːɑ
hikke	Noun	hekə
hikkori	Noun	ˈhikːori
hikkoripuu	Noun	ˈhikːoriˌpuː
hikoilla	Verb	ˈhiko̞ilːɑ
hiljaa	Adverb	ˈç̞iljɑː
hiljaisuus	Noun	ˈhiljɑisuːs
hilla	Noun	ˈhilːɑ
hillitä	Verb	ˈhilːitæˣ
hillo	Interjection	ˈhilːo
hilpari	Noun	ˈç̞ilpɑri
hilse	Noun	ˈhilse(ʔ)
hilseillä	Noun	ˈhilseilːæ
himoita	Verb	ˈhimoitɑˣ
himokas	Adjective	ˈhimo̞kɑs
hinaus	Noun	hɪˈnaʊ̯s
hinnakas	Adjective	ˈhinːɑkɑs
hinta	Noun	ˈhin̪t̪ɑ
hintti	Noun	ˈhintːi
hiostaa	Verb	ˈhiostɑː(ʔ)
hipoa	Verb	ˈhipoɑˣ
hipoen	Verb	ˈhipoen
hirmulisko	Noun	ˈhirmuˌlisko
hirnunta	Noun	ˈhirnuntɑ
hirsi	Noun	ˈhirsi
hirssi	Noun	ˈç̞irsːi
hirtehishuumori	Noun	ˈhirteɦisˌhuːmori
hirttäjä	Noun	ˈhirtːæjæ
hirttäjäiset	Noun	ˈhirtːæˌjæiset
hirttäytyä	Verb	ˈhirtːæy̯tyæˣ
hirttää	Verb	ˈhirtːæː
hirvetä	Verb	ˈhirvetæ(ʔ)
hirveä	Adjective	ˈhirveæ
hirviantilooppi	Noun	ˈhirʋiˌɑntiloːpːi
hirvikärpänen	Noun	ˈç̞irʋiˌkærpænen
hissa	Verb	ˈhisːɑ
hissikuilu	Noun	ˈhisːiˌkuilu
historia	Noun	histoˈria
hitaasti	Adverb	ˈhitɑːsti
hitausmomentti	Noun	ˈhitɑusˌmomentːi
hitsi	Noun	ˈhitsi
hiuka	Noun	ˈhiukɑ
hiukkanen	Noun	ˈç̞iukːɑnen
hiukoa	Verb	ˈhiu̯koɑˣ
hiuksenhalkominen	Noun	ˈhiuksenˌhɑlkoˌminen
hiukseton	Adjective	ˈhiukseton
hiusharja	Noun	ˈhiusˌhɑrjɑ
hiustenhalkominen	Noun	ˈhiusten ˈhɑlkominen
hiustenkuivaaja	Noun	ˈç̞iuste̞nˌkuiʋɑːjɑ
hiutale	Noun	ˈhiut̪ɑle̞ˣ
hivenaine	Noun	ˈhiʋenˌɑine(ʔ)
hobitti	Noun	ˈhobitːi
hockey	Noun	ˈhɒki
hoen	Noun	ɦun
hohtaa	Verb	ˈho̞xt̪ɑː(ʔ)
hohto	Noun	ˈhohto
hohtodiodi	Noun	ˈhohtoˌdiodi
hoi	Interjection	ɦɔi̯
hoida	Verb	ˈhoidɑ(ʔ)
hoidella	Verb	ˈho̞ide̞lːɑˣ
hoikkalori	Noun	ˈhoikːɑˌlori
hoitaa	Verb	ˈhoitɑː(ʔ)
hoksata	Verb	ˈho̞ksɑt̪ɑˣ
hokutoryu	Noun	ˈho̞kuto̞ˌriu
holhoojahallitus	Noun	ˈholɦoːjɑˌhɑlːitus
holhousvaltio	Noun	ˈholɦousˌʋɑltio
holisti	Noun	ˈholisti
holkeri	Noun	ˈholkeri
hollanninkastike	Noun	ˈholːɑnːiŋˌkɑstikeˣ
hollanninpaimenkoira	Noun	ˈholːɑnːimˌpɑimeŋˌkoirɑ
holografia	Noun	ˈholoˌɡrɑfiɑ
hologrammi	Noun	ˈholoɡrɑmːi
home	Noun	(h)əʊm
homeallergia	Noun	ˈhomeʔːˌɑlːerɡiɑ
homehtua	Verb	ˈho̞me̞çt̪uɑˣ
homejuusto	Noun	ˈhomeˌjːuːsto
homeostaasi	Noun	ˈhomeostɑːsi
hommaa	Noun	ˈhomːɑː
homobaari	Noun	ˈhomoˌbɑːri
homotella	Verb	ˈhomotella
homotsygoottinen	Adjective	ˈhomotsyɡoːtːiˌnen
homotutka	Noun	ˈhomoˌtutkɑ
homous	Noun	ˈhomous
honka	Noun	ˈhoŋkɑ
hoo	Noun	huː
hoosianna	Interjection	ˈhoːsiɑnːɑ
hopea	Noun	ˈhopeɑ
hopeamitali	Noun	ˈhopeɑˌmitɑlːi
hopeatäplä	Noun	ˈhopeɑˌtæplæ
hopeoida	Verb	ˈhopeoi̯dɑˣ
hoppu	Noun	ˈhopːu
hoputtaa	Verb	ˈho̞put̪ːɑːˣ
horjuttaa	Verb	ˈho̞rjut̪ːɑːˣ
hornantuutti	Noun	ˈhornɑnˌtuːtːi
horros	Noun	ˈhorːos
hotellihuone	Noun	ˈhotelːiˌhuone(ʔ)
hotkia	Verb	ˈho̞t̪ki.ɑˣ
hottentotti	Noun	ˈhotːentotːi
houkutella	Verb	ˈhoukutella
houkutteleva	Adjective	ˈhoukutːeleʋɑ
houre	Noun	ˈhoure(ʔ)
house	Noun	haʊs
hovi	Noun	ˈho̞ʋi
hovimestari	Noun	ˈho̞ʋiˌme̞stɑri
hovioikeus	Noun	ˈho̞ʋiˌo̞ike̞us
huhua	Noun	ˈhuhuɑ
huhuilla	Verb	ˈhuhuilːɑ(ʔ)
huhupuhe	Noun	ˈhuhuˌpuhe(ʔ)
huhuta	Verb	ˈhuhutɑ
huijari	Noun	ˈhuijɑri
huilu	Noun	ˈhuilu
huimaus	Noun	ˈhuimɑus
huiputtaa	Verb	ˈhuiput̪ːɑːˣ
huiska	Noun	ˈhuiskɑ
huiskilo	Noun	ˈhuiskilo
huitoa	Verb	ˈhui̯toɑˣ
hukat	Noun	ˈhukɑt
hukka	Noun	ˈhukːɑ
hukkaamiskielto	Noun	ˈhukːɑːmisˌkielto
hukkua	Verb	ˈhukːuɑ(ʔ)
hullaantua	Verb	ˈhulːɑːntuɑˣ
hullu	Adjective	ˈhulːu
humaani	Adjective	ˈhumɑːni
humala	Noun	ˈhumɑlɑ
humalaan	Noun	ˈhumɑlɑːn
humalassa	Noun	ˈhumɑlɑsːɑ
humista	Verb	ˈhumistɑ(ʔ)
humma	Noun	ˈhumːɑ
hummus	Noun	ˈhʊməs
humpuuki	Noun	ˈʍumpuːki
humus	Noun	ˈhjuːməs
hunaja	Noun	ˈhunɑjɑ
hunajakakku	Noun	ˈhunɑjɑˌkɑkːu
hunajaopas	Noun	ˈʍunɑjɑˌopɑs
hunajapupu	Noun	ˈhunɑjɑˌpupu
hunnuttaa	Verb	ˈʍunːut̪ːɑːˣ
hunsvotti	Noun	ˈʍunsʋo̞t̪ːi
huntu	Noun	ˈʍun̪t̪u
huoata	Verb	ˈhuɔɑt̪ɑˣ
huokea	Adjective	ˈhuo̯keɑ
huolehtia	Verb	ˈhuɔleht̪iɑˣ
huolekas	Adjective	ˈhuɔle̞kɑs
huolellinen	Adjective	ˈʍuɔlelːinen
huolestuttaneen	Verb	ˈhuolestutːɑneːn
huoli	Noun	ˈhuɔli
huolimatta	Verb	ˈhuolimɑtːɑ
huolissaan	Adverb	ˈhuolisːɑːn
huolita	Verb	ˈhuɔlitɑˣ
huolla	Verb	ˈhuolːɑ
huolto	Noun	ˈhuɔlto̞
huomata	Verb	ˈhuomɑtɑ(ʔ)
huomen	Noun	ˈhuo̯men
huomenilta	Noun	ˈhuo̯menˌiltɑ
huomisilta	Noun	ˈhuo̯misˌiltɑ
huoneenlämpö	Noun	ˈhuoneːnˌlæmpø
huonontaa	Verb	ˈhuonontɑː
huonontua	Verb	ˈhuonontuɑ(ʔ)
huonosti	Adverb	ˈʍuonosti(ʔ)
huopa	Noun	ˈhuopɑ
huopakynä	Noun	ˈhuopɑˌkynæ
huoruus	Noun	ˈhuɔruːs
huovata	Verb	ˈhuɔʋɑtɑˣ
huovuttaa	Verb	ˈʍuɔʋut̪ːɑːˣ
huovutus	Noun	ˈʍuɔʋut̪us
hupenisi	Verb	ˈhupenisi
hupi	Noun	ˈhupi
hurina	Noun	ˈhurinɑ
hurme	Noun	ˈhurme̞ˣ
hurskas	Adjective	ˈhurskɑs
hurskastella	Verb	ˈhurskɑstelːɑ
hurskaus	Noun	ˈhurskɑus
hus	Noun	huːs
hutera	Adjective	ˈhuterɑ
hutsu	Noun	ˈhutsu
huuda	Verb	ˈhuːdɑˣ
huudahdella	Verb	ˈhuːdɑxde̞lːɑˣ
huudahdus	Noun	ˈhuːdɑhdus
huudahtaa	Verb	ˈhuːdɑhtɑː(ʔ)
huudella	Verb	ˈhuːde̞lːɑˣ
huuhdella	Verb	ˈhuːhde̞lːɑˣ
huuhtelu	Noun	ˈhuːhtelu
huuli	Noun	ˈhuːli
huulikiilto	Noun	ˈʍuːliˌkiːlto̞
huulipuna	Noun	ˈʍuːliˌpunɑ
huulirasva	Noun	ˈhuːliˌrɑsʋɑ
huulisolu	Noun	ˈhuːliˌsolu
huullos	Noun	ˈhuːlːos
huuma	Noun	ˈhuːmɑ
huumaantua	Verb	ˈhuːmɑːntuɑ(ʔ)
huumata	Verb	ˈhuːmɑtɑ(ʔ)
huume	Noun	ˈhuːme
huumekoira	Noun	ˈhuːmeˌkːoirɑ
huurre	Noun	ˈʍuːrːe(ʔ)
huurteinen	Adjective	ˈhuːrteinen
huussi	Noun	ˈhuːsːi
huutaa	Verb	ˈhuːtɑːˣ
huutaen	Verb	ˈhuːtɑen
huuto	Noun	ˈhuːto
huutokauppa	Noun	ˈhuːtoˌkɑupːɑ
huutomerkki	Noun	ˈhuːtoˌmerkːi
huutopussi	Noun	ˈhuːtoˌpusːi
huvila	Noun	ˈhuʋilɑ
huvittaa	Verb	ˈhuvitːɑː(ʔ)
huvittua	Verb	ˈhuvitːuɑ(ʔ)
hyadit	Noun	ˈhyɑdit̪
hyasintti	Noun	ˈhyɑsintːi
hybridi	Noun	ˈhybridi
hybridisoitua	Verb	ˈhybridisoi̯tuɑˣ
hybris	Noun	hyːbris
hydraulimäntä	Noun	ˈhydrɑuliˌmæntæ
hygienia	Noun	ˈhyɡieniɑ
hylji	Verb	ˈhyljiˣ
hylki	Noun	ˈhɪltʃɪ
hylkiä	Verb	ˈhylki.æˣ
hylky	Noun	ˈhylky
hylsyavain	Noun	ˈhylsyˌɑʋɑin
hylätä	Verb	ˈhylætæ(ʔ)
hymen	Noun	ˈhaɪmən
hymistä	Verb	ˈhymistæ(ʔ)
hymiö	Noun	ˈhymiø̞
hymni	Noun	ˈhymni
hymnografia	Noun	ˈhymnoˌɡrɑfiɑ
hymy	Noun	ˈhymy
hyperbeli	Noun	ˈhyperbeli
hyperteksti	Noun	ˈhyperˌteksti
hypoteesi	Noun	ˈhypoteːsi
hypotenuusa	Noun	ˈhypotenuːsɑ
hypotermia	Noun	ˈhypotermiɑ
hyppiä	Verb	ˈhypːi.æˣ
hyppy	Noun	ˈhypːy
hyppypäästäinen	Noun	ˈhypːyˌpæːstæinen
hyve	Noun	ˈhyʋe̞ˣ
hyveellinen	Adjective	ˈhyʋe̞ːlːine̞n
hyvillään	Adverb	ˈhyvilːæːn
hyvinvointi	Noun	ˈhyʋinˌʋointi
hyvittää	Verb	ˈhyvitːæː
hyvyys	Noun	ˈhyʋyːs
hyvä	Adjective	ˈhyʋæ
hyväksikäyttö	Noun	ˈhyʋæksiˌkæytːø
hyväksyä	Verb	ˈhyʋæksyæˣ
hyvän	Adjective	ˈhyvæn
hyvänsäänaikana	Adverb	ˈhyvæn ˈsæːn ˈɑikɑnɑ
hyö	Pronoun	hyø
hyödytön	Adjective	ˈhyø̞dyt̪ø̞n
hyökätä	Verb	ˈhyøkætæ(ʔ)
hyönteiskarkote	Noun	ˈhyønteisˌkɑrkote(ʔ)
hyönteistiede	Noun	ˈhyø̞n̪t̪e̞isˌtie̞de̞ˣ
hyötyä	Verb	ˈhyø̞t̪yæˣ
hyötää	Verb	ˈhyø̞t̪æːˣ
hyötö	Noun	ˈhyøtø
hädin	Noun	ˈhædin
hädintuskin	Adverb	ˈhædin̪ˈt̪uskin
häijy	Adjective	ˈhæijy
häipyvä	Adjective	ˈhæipyʋæ
häirintä	Noun	ˈhæirintæ
häiriö	Noun	ˈhæiriø̞
häivyttäneen	Verb	ˈhæivytːæneːn
häkki	Noun	ˈhækːi
häkkikanala	Noun	ˈhækːiˌkɑnɑlɑ
häkä	Noun	ˈhækæ
häkämyrkytys	Noun	ˈhækæˌmyrkytys
hämähäkkiapina	Noun	ˈhæmæhækːiˌɑpinɑ
hämärtyä	Verb	ˈhæmærtyæ(ʔ)
hämärtää	Verb	ˈhæmærtæː(ʔ)
hämärä	Noun	ˈhæmæræ
hän	Pronoun	ˈhæn
häneen	Pronoun	ˈhæneːn
häneksi	Pronoun	ˈhæneksi
hänelle	Pronoun	ˈhænelːe(ʔ)
hänellä	Pronoun	ˈhænelːæ
häneltä	Pronoun	ˈhæneltæ
hänenä	Pronoun	ˈhænenæ
hänessä	Pronoun	ˈhænesːæ
hänettä	Pronoun	ˈhænetːæ
hännystakki	Noun	ˈhænːysˌtɑkːi
häntä	Noun	ˈhæn̪t̪æ
häntärekursio	Noun	ˈhæntæˌre̞kursio̞
häpeissään	Adverb	ˈhæpeisːæːn
häpeä	Noun	ˈhæpeæ
häpeärangaistus	Noun	ˈhæpeæˌrɑŋːɑistus
häpyhuuli	Noun	ˈhæpyˌhuːli
häpykieli	Noun	ˈhæpyˌkie̞li
häpykukkula	Noun	ˈhæpyˌkukːulɑ
häpykumpu	Noun	ˈhæpyˌkumpu
härkä	Noun	ˈhærkæ
härkäsimppu	Noun	ˈhærkæˌsimpːu
härskiintynyt	Adjective	ˈhærskiːnˌtynyt
härskiintyä	Verb	ˈhærskiːn̪t̪yæˣ
härö	Noun	ˈhærø
hätä	Noun	ˈhætæ
hätäjarru	Noun	ˈhætæˌjɑrːu
hätäjarrutus	Noun	ˈhætæˌjɑrːutus
hätänumero	Noun	ˈhætæˌnumero
hävettää	Verb	ˈhævetːæː(ʔ)
hävetä	Verb	ˈhævetæ(ʔ)
hävittää	Verb	ˈhævitːæː(ʔ)
hävitys	Noun	ˈhæʋitys
hävitä	Verb	ˈhæʋit̪æˣ
häviö	Noun	ˈhæʋiø
häät	Noun	ˈhæːt̪
häätö	Noun	ˈhæːtø
hääyöaie	Noun	ˈhæːˌyøˌɑie(ʔ)
höhlä	Noun	ˈhøclæ
hölmö	Adjective	ˈhø̞lmø̞
höltyä	Verb	ˈhø̞l̪t̪yæ
höpinä	Noun	ˈhø̞pinæ
hörppiä	Verb	ˈhø̞rpːi.æˣ
höyhenpeite	Noun	ˈhøyɦenˌpeite(ʔ)
höyhentuppi	Noun	ˈhøyɦenˌtupːi
höyhenväkänen	Noun	ˈhøyɦenˌʋækænen
höynäyttää	Verb	ˈhøynæytːæː
höyryjyrä	Noun	høyryjyræ
höyrykone	Noun	ˈhøyryˌkone(ʔ)
höyryveturi	Noun	ˈhøyryˌʋeturi
höystää	Verb	ˈhøystæː
ikäero	Noun	ˈikæˌero
ikäraja	Noun	ˈikæˌrɑjɑ
ikävä	Adjective	ˈikæʋæ
iljettävä	Adjective	ˈiljetːæʋæ
iljetä	Verb	ˈiljetæ(ʔ)
ilma	Preposition	ˈilmɑ
ilmahehku	Noun	ˈilmɑˌhehku
ilmaiset	Adjective	ˈilmɑise̞t̪
ilmajuuri	Noun	ˈilmɑˌjuːri
ilmakitara	Noun	ˈilmɑˌkitɑrɑ
ilmapatsas	Noun	ˈilmɑˌpɑtsɑs
ilmarako	Noun	ˈilmɑˌrɑko
ilmasto	Noun	ˈilmɑsto
ilmastointi	Noun	ˈilmɑstoi̯nti
ilmastotiede	Noun	ˈilmɑst̪o̞ˌt̪ie̞de̞
ilmatila	Noun	ˈilmɑˌtilɑ
ilmavarsi	Noun	ˈilmɑˌʋɑrsi
ilmaverso	Noun	ˈilmɑˌʋerso
ilmavoimat	Noun	ˈilmɑˌʋoimɑt
ilme	Noun	ˈilme
ilmetty	Adjective	ˈilmetːy(ʔ)
ilmiö	Noun	ˈilmiø
ilmiömäinen	Adjective	ˈilmiøˌmæinen
ilmiömäisesti	Adverb	ˈilmiøˌmæisesti
ilo	Noun	ˈilo
iloisesti	Adverb	ˈiloisesti
ilta	Noun	ˈiltɑ
iltapäivä	Noun	ˈiltɑˌpæi̯ʋæ
iltatähti	Noun	ˈiltɑˌtæhti
iltayö	Noun	ˈiltɑˌyø̯
imaginaariosa	Noun	ˈimɑɡinɑːriˌosɑ
imaginääriosa	Noun	ˈimɑɡinæːriˌosɑ
ime	Noun	ˈime̞ˣ
imeä	Verb	ˈime̞.æˣ
immyt	Noun	ˈimːyt̪
implikoida	Verb	ˈimplikoidɑ(ʔ)
impulsiivisuus	Noun	ˈimpulsiːʋisuːs
impulssi	Noun	ˈimpulsːi
imu	Noun	ˈimu
imujuuri	Noun	ˈimuˌjuːri
imukala	Noun	ˈimuˌkɑlɑ
imukuppi	Noun	ˈimuˌkupːi
imukärsä	Noun	ˈimuˌkærsæ
imuri	Noun	ˈimuri
imuroida	Verb	ˈimuroida(ʔ)
imurointi	Noun	ˈimurointi
imusolmuke	Noun	ˈimuˌsolmuke(ʔ)
imusuoni	Noun	ˈimuˌsuɔni
imuttaa	Verb	ˈimutːɑːˣ
indigonsininen	Noun	ˈindiɡonˌsininen
inessiivi	Noun	ˈinesːiːʋi
infinitiivi	Noun	ˈinfinitiːvi
informaatio	Noun	ˈiɱforˌmɑːtio
infraääni	Noun	ˈiɱfrɑˌæːni
inhimillinen	Adjective	ˈinç̞imilːinen
inka	Noun	ˈiŋkɑ
inkivääri	Noun	ˈiŋkiʋæːri
inkunaabeli	Noun	ˈiŋkuˌnɑːbeli
inkvisitorinen	Adjective	ˈiŋkivisitorinen
innoissaan	Adverb	ˈinːoisːɑːn
innovaatio	Noun	ˈinːo̞ʋɑːt̪io̞
insesti	Noun	ˈinsesti
installointi	Noun	ˈinstɑlːointi
interferoni	Noun	ˈin̪t̪e̞rˌfe̞ro̞ni
intervalli	Noun	ˈinterʋɑlːi
intiaanikesä	Noun	ˈintiɑːniˌkesæ
into	Preposition	ˈɪn.tuː
invalidi	Noun	ˈinʋɑˌliːdi
ioni	Noun	ˈioni
ioota	Noun	ˈjoːtɑ
irkata	Verb	ˈirkɑt̪ɑˣ
irrottaa	Verb	ˈirːotːɑː(ʔ)
irstailu	Noun	ˈirstɑilu
irti	Adverb	ˈirtiˣ
irtisanomisaika	Noun	ˈirtiˌsɑnomisˌɑikɑ
isentrooppinen	Adjective	ˈisentˌroːpːinen
iskettäneen	Verb	ˈisketːæneːn
isketään	Verb	ˈisketæːn
iskeytyä	Verb	ˈiskey̯tyæˣ
iskias	Noun	ˈiskiɑs
iskukuumennus	Noun	ˈiskuˌkuːmenːus
iskuvasara	Noun	ˈiskuˌʋɑsɑrɑ
islamilainenfundamentalismi	Noun	ˈislɑmiˌlɑinen ˈfundɑˌmentɑˌlismi
islamintutkija	Noun	ˈislɑminˌtutkijɑ
islantilainen	Noun	ˈislɑn̪t̪iˌlɑine̞n
isohapero	Noun	ˈisoˌhɑpero
isotella	Verb	ˈisotelːɑ(ʔ)
isovarvas	Noun	ˈiso̞ˌʋɑrʋɑs
isoympyrä	Noun	ˈiso̞ˌympyræ
istahtaa	Verb	ˈistɑxtɑː(ʔ)
istua	Verb	ˈistuɑˣ
istuin	Noun	ˈistuin
istukkaan	Noun	ˈistukːɑːn
isä	Noun	ˈisæ
isäntä	Noun	ˈisæn̪t̪æ
itikka	Noun	ˈitikːɑ
itiö	Noun	ˈitiø
itiöemä	Noun	ˈitiøˌemæ
itiölava	Noun	ˈitiøˌlɑʋɑ
itkettää	Verb	ˈit̪ke̞tːæː(ʔ)
itkeä	Verb	ˈit̪ke̞.æˣ
itkijä	Noun	ˈit̪kijæ
itkupilli	Noun	ˈitkuˌpilːi
itse	Prefix	ˈit̪seˣ
itseisarvo	Noun	ˈitseisˌɑrʋo
itseiva	Noun	ˈit̪se̞ˌʔiʋɑ
itsemme	Pronoun	ˈitsemːe
itseni	Pronoun	ˈitseni
itsenne	Pronoun	ˈitsenːe
itsensä	Pronoun	ˈitsensæ(ʔ)
itsenäisyys	Noun	ˈit̪se̞næisyːs
itsepetos	Noun	ˈit̪se̞ˌpːe̞t̪o̞s
itsepäinen	Adjective	ˈitseˌpːæinen
itsesi	Pronoun	ˈitsesi
itsesiitos	Noun	ˈitseˌsiːtos
itä	Noun	ˈitæ
itää	Noun	ˈitæː
iva	Numeral	ˈiːva
ivata	Verb	ˈivɑtɑ(ʔ)
iäti	Adverb	ˈiæti
jammata	Verb	ˈjɑmːɑtɑ
jana	Noun	ˈjɑnɑ
jankko	Noun	ˈjɑŋkːo
jano	Noun	ˈjɑno
janoissaan	Adverb	ˈjɑnoi̯sːɑːn
jaosto	Noun	ˈjɑo̞sto̞
japanilaisuus	Noun	ˈjɑpɑniˌlɑi̯suːs
japsi	Noun	ˈjɑpsi
jargon	Noun	ˈdʒɑɹ.ɡən
jarru	Noun	ˈjɑrːu
jarrupoljin	Noun	ˈjɑrːuˌpo̞ljin
jatkaa	Verb	ˈjɑtkɑːˣ
jatkaasukua	Verb	ˈjɑtkɑː ˈsːukuɑ
jatkua	Verb	ˈjɑtkuɑ(ʔ)
jatkumo	Noun	ˈjɑtkumo
jatkuvuus	Noun	ˈjɑtkuvuːs
jauhaapaskaa	Verb	ˈjɑuhɑː ˈpːɑskɑː
jauhelihapihvi	Noun	ˈjɑuɦeˌlːiɦɑˌpiçʋi
jazz	Noun	d͡ʒæz
jee	Verb	jeː
jeeppi	Noun	ˈjeːpːi
jelppiä	Verb	ˈje̞lpːi.æˣ
jenkka	Noun	ˈje̞ŋkːɑ
jersey	Noun	ˈdʒəːzi
jerseyneulos	Noun	ˈdʒøːziˌneu̯los
jessör	Interjection	ˈje̞ssɶːr
jii	Noun	ˈjiː
jo	Noun	dʒoː
jockey	Noun	ˈdʒɒki
jodlaus	Noun	ˈjodlɑus
johde	Noun	ˈjo̞xde̞ˣ
johtaa	Verb	ˈjohtɑː(ʔ)
johtaaharhaan	Verb	ˈjoxtɑːˈhːɑrɦɑːn
johteinen	Adjective	ˈjoxteinen
johto	Noun	ˈjohto
johtojänne	Noun	ˈjoxtoˌjænːe(ʔ)
johtosarja	Noun	ˈjoxtoˌsɑrjɑ
johtosolukko	Noun	ˈjoxtoˌsolukːo
joi	Pronoun	ˈjoi
joisi	Verb	ˈjo̞isi
jojo	Noun	ˈjo̞jo̞
jokainen	Pronoun	ˈjokɑinen
jokamiehenoikeus	Noun	ˈjo̞kɑˌmie̞ɦe̞nˌo̞ike̞us
jokeri	Noun	ˈjo̞ke̞ri
jokimainen	Adjective	ˈjokiˌmɑinen
jokivene	Noun	ˈjokiˌʋeneˣ
jollei	Conjunction	ˈjolːei
jompikumpi	Pronoun	ˈjo̞mpiˌkumpi
jonkin	Pronoun	ˈjoŋkin
jono	Noun	ˈjono
jonottaa	Verb	ˈjonotːɑː(ʔ)
joo	Adverb	joː
jooga	Noun	ˈjoːɡɑ
jopa	Adverb	ˈjopɑ
joriini	Noun	ˈjoriːni
jos	Conjunction	ˈjos
jossittelu	Noun	ˈjosːitːelu
jota	Noun	ˈhoʊtə
jotta	Conjunction	ˈjotːɑ
jou	Pronoun	jɑu̯
jouhipaita	Noun	ˈjouɦiˌpɑitɑ
joukkotuhoase	Noun	ˈjo̞ukːo̞ˌt̪uɦo̞ˌɑse̞ˣ
joukkotuhonta	Noun	ˈjo̞ukːo̞ˌtuɦo̞n̪t̪ɑ
joukkue	Noun	ˈjo̞ukːu.e̞ˣ
joulukalenteri	Noun	ˈjou̯luˌkɑlenteri
joulunaika	Noun	ˈjou̯lunˌɑi̯kɑ
jousi	Noun	ˈjo̞usi
joutaa	Verb	ˈjoutɑː
joutilaisuus	Noun	ˈjoutiˌlɑisuːs
joutohede	Noun	ˈjoutoˌhede(ʔ)
joutsen	Noun	ˈjou̯tsen
joutua	Verb	ˈjo̞ut̪u.ɑˣ
juhannus	Noun	ˈjuɦɑnːus
juju	Noun	ˈdʒuːdʒu
jukka	Noun	ˈjukːɑ
julistaa	Verb	ˈjulistɑː(ʔ)
juljeta	Verb	ˈjuljetɑ(ʔ)
julkaista	Verb	ˈjulkɑi̯stɑˣ
julkeus	Noun	ˈjulkeus
jumala	Adverb	ˈjumɑlɑ
jumalauta	Interjection	ˈjumɑlˌɑut̪ɑ
jumbojetti	Noun	ˈjumboˌjetːi
junaasema	Noun	ˈjunɑʔˌɑsemɑ
juo	Verb	juo
juoda	Verb	ˈjuo̯dɑˣ
juoksemaan	Verb	ˈjuoksemɑːn
juoksemasta	Verb	ˈjuoksemɑstɑ
juoksu	Noun	ˈjuɔksu
juoma	Noun	ˈjuomɑ
juominen	Noun	ˈjuominen
juostaan	Verb	ˈjuostɑːn
juostaneen	Verb	ˈjuostɑneːn
juostiin	Verb	ˈjuostiːn
juottaa	Verb	ˈjuɔtːɑːˣ
juristi	Noun	ˈjuristi
just	Adjective	d͡ʒʌst
juttu	Noun	ˈjutːu
juu	Interjection	juː
juurihuntu	Noun	ˈjuːriˌhuntu
juurikarva	Noun	ˈjuːriˌkɑrʋɑ
juurilaho	Noun	ˈjuːriˌlɑɦo
juurinystyrä	Noun	ˈjuːriˌnystyræ
juuripaine	Noun	ˈjuːriˌpɑine(ʔ)
juurisilmu	Noun	ˈjuːriˌsilmu
juurivesa	Noun	ˈjuːriˌʋesɑ
juusto	Noun	ˈjuːsto
jyrketä	Verb	ˈjyrketæ
jyvä	Noun	ˈjyʋæ
jyvässolu	Noun	ˈjyʋæsˌsolu
jäi	Verb	jæi
jäinen	Adjective	ˈjæinen
jäkälä	Noun	ˈjækælæ
jäljittää	Verb	ˈjæljitːæː
jälkijuuri	Noun	ˈjælkiˌjuːri
jälkikäsittely	Noun	ˈjælkiˌkæsit̪ːe̞ly
jälkimaailma	Noun	ˈjælkiˌmɑːilmɑ
jälkimmäinen	Adjective	ˈjælkimːæinen
jälkisilmu	Noun	ˈjælkiˌsilmu
jälleen	Adverb	ˈjælːeːn
jänisrutto	Noun	ˈjænisˌrutːo
jänne	Noun	ˈjænːe
jännite	Noun	ˈjænːiteˣ
järjestyä	Verb	ˈjærjestyæ(ʔ)
järjestää	Verb	ˈjærjestæː(ʔ)
järkeenkäypä	Adjective	ˈjærkeːŋˌkæypæ
järkeily	Noun	ˈjærkeily
järvi	Noun	ˈjærʋi
järvisyyhy	Noun	ˈjærʋiˌsyːɦy
järähdellä	Verb	ˈjæræçˌde̞lːæˣ
jäte	Noun	ˈjæt̪e̞ˣ
jätkä	Noun	ˈjætkæ
jättää	Verb	ˈjætːæːˣ
jättöpyörre	Noun	ˈjæt̪ːø̞ˌpyø̞rːe̞ˣ
jättösarvi	Noun	ˈjætːøˌsɑrʋi
jätättää	Verb	ˈjæt̪æt̪ːæːˣ
jäykkäkouristus	Noun	ˈjæykːæˌkouristus
jää	Noun	ˈjæː
jäädyke	Noun	ˈjæːdyke̞ˣ
jäädyttää	Verb	ˈjæːdytːæː(ʔ)
jäädä	Verb	ˈjæːdæˣ
jääkaappi	Noun	ˈjæːˌkɑːpːi
jääkahvi	Noun	ˈjæːˌkɑħʋi
jääkausi	Noun	ˈjæːˌkɑu̯si
jääkenttä	Noun	ˈjæːˌkentːæ
jääkiekkokaukalo	Noun	ˈjæːkiekːokɑukɑlo
jääluokitus	Noun	ˈjæːˌluokitus
jäänaskali	Noun	ˈjæːˌnɑskɑli
jäännöslopuke	Noun	ˈjæːnːø̞sˌlo̞puke̞ˣ
jääsukellus	Noun	ˈjæːˌsukelːus
jäätelö	Noun	ˈjæːtelø
jäätymispiste	Noun	ˈjæːt̪ymisˌpiste̞ˣ
jäätyä	Verb	ˈjæːtyæˣ
jäävi	Adjective	ˈjæːʋi
jääviys	Noun	ˈjæːviys
jäävätä	Verb	ˈjæːvætæ(ʔ)
jöö	Noun	jøː
kanadanvireo	Noun	ˈkɑnɑdɑnˌʋireo
kanaemo	Noun	ˈkɑnɑˌemo
kanala	Noun	ˈkɑnɑlɑ
kanalasagne	Noun	ˈkɑnɑˌlɑsɑɡne
kanalauma	Noun	ˈkɑnɑˌlɑumɑ
kanalja	Noun	ˈkɑnɑljɑ
kanamainen	Adjective	ˈkɑnɑˌmɑinen
kanarianhemppo	Noun	ˈkɑnɑriɑnˌhempːo
kanariankirvinen	Noun	ˈkɑnɑriɑŋˌkirʋinen
kanariankyyhky	Noun	ˈkɑnɑriɑŋˌkyːhky
kanarianpeippo	Noun	ˈkɑnɑriɑmˌpeipːo
kanariantasku	Noun	ˈkɑnɑriɑnˌtɑsku
kanava	Noun	ˈkɑnɑʋɑ
kandela	Noun	ˈkɑndelɑ
kaneli	Noun	ˈkɑne̞li
kanelisorsa	Noun	ˈkɑn̪e̞liˌso̞rsɑ
kanerva	Noun	ˈkɑnerʋɑ
kangas	Noun	ˈkɑŋːɑs
kangaskorte	Noun	ˈkɑŋːɑsˌkorteˣ
kangastus	Noun	ˈkɑŋːɑstus
kani	Verb	ˈkɑni
kaniini	Noun	ˈkɑniːni
kanjoni	Noun	ˈkɑnjoni
kankaat	Noun	ˈkɑŋkɑːt
kankaiden	Noun	ˈkɑŋkɑiden
kankaiksi	Noun	ˈkɑŋkɑiksi
kankailla	Noun	ˈkɑŋkɑilːɑ
kankaille	Noun	ˈkɑŋkɑilːeˣ
kankailta	Noun	ˈkɑŋkɑiltɑ
kankain	Noun	ˈkɑŋkɑin
kankaina	Noun	ˈkɑŋkɑinɑ
kankaineen	Noun	ˈkɑŋkɑineːn
kankaisiin	Noun	ˈkɑŋkɑisiːn
kankaissa	Noun	ˈkɑŋkɑisːa
kankaista	Noun	ˈkɑŋkɑistɑ
kankaita	Noun	ˈkɑŋkɑitɑ
kankaitta	Noun	ˈkɑŋkɑitːɑ
kankaitten	Noun	ˈkɑŋkɑitːen
kankkunen	Noun	ˈkɑŋkːune̞n
kannas	Noun	ˈkɑnːɑs
kannattajanikama	Noun	ˈkɑnːɑtːɑjɑˌnikɑmɑ
kannatus	Noun	ˈkɑnːɑtus
kanneksia	Verb	ˈkɑnːe̞ksi.ɑˣ
kannella	Noun	ˈkɑnːe̞lːɑ
kannettava	Adjective	ˈkɑnːetːɑvɑ
kannu	Noun	ˈkɑnːu
kansa	Noun	ˈkɑnsɑ
kansainvälisetkovapanosammunnat	Noun	ˈkɑnsɑinˌʋæliset ˈkovɑpɑnosˌɑmːunːɑt
kansalaisliike	Noun	ˈkɑnsɑlɑisˌliːke
kansalaisyhteiskunta	Noun	ˈkɑnsɑlɑi̯sˌyhtei̯skuntɑ
kansallispuisto	Noun	ˈkɑnsɑlːisˌpuisto
kansallissosialisti	Noun	ˈkɑnsɑlːisˌsosiɑlisti
kansallisuus	Noun	ˈkɑnsɑˌlːisuːs
kansanedustaja	Noun	ˈkɑnsɑnˌedustɑjɑ
kansanlaulu	Noun	ˈkɑnsɑnˌlɑulu
kansanmurha	Noun	ˈkɑnsɑmˌmurɦɑ
kansanmusiikki	Noun	ˈkɑnsɑnˌmusiːkːi
kansannousu	Noun	ˈkɑnsɑnˌnousu
kansanäänestys	Noun	ˈkɑnsɑnˌæːnestys
kansi	Noun	ˈkɑnsi
kansikota	Noun	ˈkɑnsiˌkotɑ
kansio	Noun	ˈkɑnsio
kanta	Noun	ˈkɑn̪t̪ɑ
kantaa	Noun	ˈkɑntɑː
kantaitiö	Noun	ˈkɑn̪t̪ɑˌitiø
kantaja	Noun	ˈkɑntɑjɑ
kantama	Noun	ˈkɑntɑmɑ
kantapää	Noun	ˈkɑntɑˌpæː
kantasolututkimus	Noun	ˈkɑntɑsoluˌtutkimus
kantautua	Verb	ˈkɑntɑutuɑ(ʔ)
kantoraketti	Noun	ˈkɑntoˌrɑketːi
kantri	Noun	ˈkɑn̪t̪ri
kantrimusiikki	Noun	ˈkɑn̪t̪riˌmusiːkːi
kanttori	Noun	ˈkɑntːori
kanuuna	Noun	ˈkɑnuːnɑ
kapea	Adjective	ˈkɑpeɑ
kapellimestari	Noun	ˈkɑpe̞lːiˌme̞stɑri
kapinoida	Verb	ˈkɑpino̞idɑ
kapitalismi	Noun	ˈkɑpitɑlismi
kappa	Noun	ˈkæpə
kappale	Noun	ˈkɑpːɑle(ʔ)
kapris	Noun	ˈkɑpris
kapula	Noun	ˈkɑpulɑ
karaatti	Noun	ˈkɑrɑːt̪ːi
karahvi	Noun	ˈkɑrɑhʋi
karata	Verb	ˈkɑrɑtɑ
kardemumma	Noun	ˈkɑːrde̞mumːɑ
karhi	Noun	ˈkarɦi
karho	Noun	ˈkɑrxo̞
karhu	Noun	ˈkɑrhu
karhukainen	Noun	ˈkɑrɦuˌkɑinen
karhukissa	Noun	ˈkɑrhuˌkisːɑ
karhunpeijaiset	Noun	ˈkɑrɦumˌpe̞ijɑise̞t̪
kari	Noun	ˈkarɪ
karisma	Noun	karisma
karitsa	Noun	ˈkɑritsɑ
karja	Noun	ˈkɑrjɑ
karjaaura	Noun	ˈkɑrjɑ(ʔ)ˌɑurɑ
karjala	Noun	ˈkɑrjɑlɑ
karju	Noun	ˈkɑrju
karjuko	Verb	ˈkɑrjuko̞ˣ
karkauspäivä	Noun	ˈkɑrkɑu̯sˌpæi̯ʋæ
karkausvuosi	Noun	ˈkɑrkɑu̯sˌʋuo̯si
karkki	Noun	ˈkɑrkːi
karma	Noun	ˈkɑɹmə
karmia	Noun	ˈkɑrmiɑˣ
karsinan	Noun	ˈkɑrsinɑn
karsinogeeni	Noun	ˈkɑrsinoɡeːni
kartoitus	Noun	ˈkɑrtoitus
kartonki	Noun	ˈkɑrtoŋki
karttaa	Noun	ˈkɑrtːɑː
karttapallo	Noun	ˈkɑrtːɑˌpɑlːo
karuselli	Noun	ˈkɑruse̞lːi
karva	Noun	ˈkɑrʋɑ
karvanvaihto	Noun	ˈkɑrʋɑnˌʋɑiç̞to
karviainen	Noun	ˈkɑrʋiɑinen
kasakka	Noun	ˈkɑsɑkːɑ
kasari	Noun	ˈkɑsɑri
kasarmi	Noun	ˈkɑsɑrmi
kasetti	Noun	ˈkɑsetːi
kasino	Noun	ˈkɑsino̞
kasku	Noun	ˈkɑsku
kassa	Noun	ˈkɑsːɑ
kassi	Noun	ˈkɑsːi
kastaa	Verb	ˈkɑstɑː
kastane	Verb	ˈkɑstɑne
kaste	Noun	ˈkɑstə
kastella	Verb	ˈkɑste̞lːɑˣ
kastelukannu	Noun	ˈkɑsteluˌkɑnːu
kastemato	Noun	ˈkɑsteˌmːɑto
kastepiste	Noun	ˈkɑsteˌpːiste(ʔ)
kastua	Verb	ˈkɑstuɑ(ʔ)
kasvaa	Verb	ˈkɑsvɑː(ʔ)
kasvain	Noun	ˈkɑsvɑin
kasvattaa	Verb	ˈkasvattaa(ʔ)
kasvihuoneilmiö	Noun	ˈkɑsʋiˌxuoneʔˌilmiø
kasvillisuus	Noun	ˈkɑsʋilːisuːs
kasvinsyöjä	Noun	ˈkɑsʋinˌsyøjæ
kasviplankton	Noun	ˈkɑsʋiˌplɑŋkton
kasvirasva	Noun	ˈkɑsʋiˌrɑsʋɑ
kasvis	Noun	ˈkɑsʋis
kasvissyöjä	Noun	ˈkɑsʋisˌsyøjæ
kasviöljy	Noun	ˈkɑsʋiˌø̞ljy
kasvot	Noun	ˈkɑsʋot
kasvukausi	Noun	ˈkɑsʋuˌkɑusi
kasvulehti	Noun	ˈkɑsʋuˌlehti
kasvusolukko	Noun	ˈkɑsʋuˌsolukːo
kataja	Noun	ˈkɑt̪ɑjɑ
katajanmarja	Noun	ˈkɑt̪ɑjɑnˌmɑrjɑ
katalysoida	Verb	ˈkɑtɑlyˌsoidɑ(ʔ)
katalyysi	Noun	ˈkɑtɑlyːsi
katapultti	Noun	ˈkɑtɑpultːi
katastrofi	Noun	ˈkɑtɑstrofi
katekeetta	Noun	ˈkɑteˌkeːtːɑ
katiska	Noun	ˈkɑ.tis.kɑ
katkaisija	Noun	ˈkɑt̪kɑisijɑ
katkaisu	Noun	ˈkɑtkɑisu
katki	Adverb	ˈkɑtki
katku	Noun	ˈkɑt̪ku
kato	Noun	ˈkato
katoavainen	Adjective	ˈkɑtoɑʋɑinen
katrilli	Noun	ˈkɑt̪rilːi
katse	Noun	ˈkɑtseˣ
katseenvangitsija	Noun	ˈkɑt̪se̞ːnˌʋɑŋːit̪sijɑ
katsella	Verb	ˈkɑt̪se̞lːɑˣ
katsellen	Verb	ˈkɑtselːen
katsoa	Verb	ˈkɑtsoɑ
katsoja	Noun	ˈkɑt̪so̞jɑ
katsomuksellinen	Adjective	ˈkɑtsomukselːinen
kattaa	Verb	ˈkɑtːɑː(ʔ)
kattokruunu	Noun	ˈkɑtːoˌkruːnu
kattoon	Noun	ˈkɑtːoːn
katu	Noun	ˈkɑtu
katua	Noun	ˈkɑtuɑ
katumaasturi	Noun	ˈkɑtuˌmɑːsturi
katuuskottavuus	Noun	ˈkɑtu(ʔ)ˌuskotːɑʋuːs
kauan	Adverb	ˈkɑuɑn
kauha	Noun	ˈkɑuhɑ
kauhoa	Verb	ˈkɑuɦoɑ(ʔ)
kauhu	Noun	ˈkɑuɦu
kauhuissaan	Adverb	ˈkɑuɦuisːɑːn
kaukainen	Adjective	ˈkɑukɑine̞n
kaukalo	Noun	ˈkɑukɑlo
kauko	Prefix	ˈkɑuko̞
kaukolämmitys	Noun	ˈkɑuko̞ˌlæmːit̪ys
kaukolämpö	Noun	ˈkɑuko̞ˌlæmpø̞
kaukonäköisyys	Noun	ˈkɑukoˌnækøisyːs
kaukopuhelu	Noun	ˈkɑuko̞ˌpuɦe̞lu
kaukosäädin	Noun	ˈkɑuko̞ˌsæːdin
kaula	Noun	ˈkɑu̯lɑ
kaulata	Verb	ˈkɑulɑt̪ɑˣ
kaulin	Noun	ˈkɑ͡ulin
kauna	Noun	ˈkɑunɑ
kauneus	Noun	ˈkɑune̞us
kaunis	Adjective	ˈkɑu̯nis
kaunokki	Noun	ˈkɑunokːi
kaunoluistelu	Noun	ˈkaunoluistelu
kaunotar	Noun	ˈkɑuno̞t̪ɑr
kaupaksi	Noun	ˈkːɑupɑksi
kauppa	Noun	ˈkɑu̯pːɑ
kaupunkiverkko	Noun	ˈkɑupunkiˌʋerkːo
kaura	Noun	ˈkɑu̯rɑ
kauris	Noun	ˈkɑuris
kausi	Noun	ˈkɑu̯si
kausityöttömyys	Noun	ˈkɑusiˌtyøtːømyːs
kavallus	Noun	ˈkɑʋɑlːus
kavaltaa	Verb	ˈkɑʋɑltɑːˣ
kaveri	Noun	ˈkɑʋeri
keeppi	Noun	ˈkeːpːi
kefalosporiini	Noun	ˈkefɑloˌsporiːni
kehdata	Verb	ˈkeçdɑtɑ(ʔ)
kehen	Pronoun	ˈkehen
kehite	Noun	ˈkeɦite(ʔ)
kehittämisstrategia	Noun	ˈkeɦitːæmisˌstrɑteɡiɑ
kehittää	Verb	ˈkeɦitːæːˣ
kehitys	Noun	ˈkeɦitys
kehitysaste	Noun	ˈkeɦitysˌɑsteˣ
kehityshistoria	Noun	ˈkeɦitysˌhistoriɑ
kehityshäiriö	Noun	ˈke̞ɦit̪ysˌcæiriø̞
kehityskulku	Noun	ˈkeɦitysˌkulku
kehitysoppi	Noun	ˈkeɦitysˌopːi
kehkeytyä	Verb	ˈkehkey̯tyæˣ
kehnä	Noun	ˈke̞hnæ
kehollinen	Adjective	ˈkeɦolːinen
kehrätä	Verb	ˈkehrætæ(ʔ)
kehrääjä	Noun	ˈkehræːjæ
kehräämö	Noun	ˈkexræːmø
kehto	Noun	ˈke̞ht̪o̞
kehtopainate	Noun	ˈkextoˌpɑinɑteˣ
kehua	Noun	ˈke̞ɦuɑˣ
kehäkukka	Noun	ˈkehæˌkukːɑ
kehäkulma	Noun	ˈkehæˌkulmɑ
kehälehti	Noun	ˈke̞ɦæˌle̞ht̪i
kehäpäätelmä	Noun	ˈkehæˌpæːtelmæ
kehäriutta	Noun	ˈkeɦæˌriutːɑ
keidas	Noun	ˈke̞idɑs
keidassuo	Noun	ˈkeidɑsˌsuo
keiden	Pronoun	ˈkeiden
keihin	Pronoun	ˈkeihin
keihäsantilooppi	Noun	ˈkeihæsˌɑntiloːpːi
keihäänheitto	Noun	ˈkeiɦæːnˌheitːo
keija	Noun	ˈkeijːɑ
keiju	Noun	ˈkeiju
keijua	Verb	ˈkeijuɑ(ʔ)
keijusto	Noun	ˈkeijusto
keilapallo	Noun	ˈke̞ilɑˌpɑlːo̞
keino	Prefix	ˈkeino
keinohedelmöitys	Noun	ˈkeinoˌhedelmøitys
keinoäly	Noun	ˈke̞ino̞ˌæly
keinu	Noun	ˈke̞inu
keinuhevonen	Noun	ˈke̞inuˌhe̞ʋo̞ne̞n
keisarifregattilintu	Noun	ˈkeisɑriˌfreɡɑtːiˌlintu
keisarileikkaus	Noun	ˈkeisɑriˌleikːɑus
keisarinviitta	Noun	ˈkeisɑrinˌʋiːtːɑ
keisaritamariini	Noun	ˈkeisɑriˌtɑmɑriːni
keite	Noun	ˈkeiteˣ
keitin	Noun	ˈkeitin
keitten	Pronoun	ˈkeitːen
keitto	Prefix	ˈkeitːo
keittokirja	Noun	ˈkeitːoˌkirjɑ
keittäjä	Noun	ˈke̞it̪ːæjæ
keittää	Verb	ˈkei̯tːæːˣ
keitä	Pronoun	ˈkeit̪æ
kekkerit	Noun	ˈke̞kːe̞rit
kekomuurahainen	Noun	ˈkekoˌmuːrɑɦɑinen
keksi	Noun	ˈkeksi
keksijä	Noun	ˈke̞ksijæ
kelata	Verb	ˈke̞lɑt̪ɑˣ
kelkka	Noun	ˈkelkːɑ
kellastuttaa	Verb	ˈkelːɑsˌtutːɑː
kellertää	Verb	ˈke̞lːe̞rtæːˣ
kello	Noun	ˈkelːo
kellokeskiviikko	Noun	ˈkelːoˌkeskiʋiːkːo
kellokoneisto	Noun	ˈke̞lːo̞ˌko̞ne̞isto̞
kellotaulu	Noun	ˈke̞lːo̞ˌt̪ɑulu
kelo	Noun	ˈkelo
kelopääsky	Noun	ˈke̞lo̞ˌpæːsky
kelpoisuus	Noun	ˈkelpoisuːs
keltainen	Adjective	ˈkeltɑi̯nen
keltarauhanen	Noun	ˈkeltɑˌrɑuɦɑnen
keltarauhashormoni	Noun	ˈke̞ltɑˌrɑuɦɑsˌxo̞rmo̞ni
keltiäinen	Noun	ˈkeltiæinen
kemia	Adjective	ˈke̞miɑ
ken	Verb	kɛn
keneen	Pronoun	ˈkeneːn
keneksi	Pronoun	ˈkeneksi
kenelle	Pronoun	ˈkenelːe(ʔ)
kenellä	Pronoun	ˈkenelːæ
keneltä	Pronoun	ˈkeneltæ
kenenä	Pronoun	ˈkenenæ
kenestä	Pronoun	ˈkenestæ
kenettä	Pronoun	ˈkenetːæ
kenguru	Noun	ˈkeŋːuru
kengänkieli	Noun	ˈkeŋːæŋˌkieli
kengänkärki	Noun	ˈkeŋːæŋˌkærki
kengännauha	Noun	ˈkeŋːænˌnɑuɦɑ
kengännumero	Noun	ˈkeŋːæˌnːumero
kengänpohja	Noun	ˈkeŋːæmˌpoxjɑ
kenkä	Noun	ˈkeŋkæ
kenkälaatikko	Noun	ˈkeŋkæˌlɑːtikːo
kenkäpari	Noun	ˈkeŋkæˌpɑri
kenkäteollisuus	Noun	ˈkeŋkæˌteolːisuːs
kenkään	Noun	ˈkenkæːn
kennomainen	Adjective	ˈkenːoˌmɑinen
kenotsooinen	Adjective	ˈke̞no̞t̪so̞ːine̞n
kenoviiva	Noun	ˈke̞no̞ˌʋiːʋɑ
kenraaliharjoitus	Noun	ˈkenrɑːliˌhɑrjoitus
kenttä	Noun	ˈke̞n̪t̪t̪æ
keplotella	Verb	ˈke̞plo̞t̪e̞lːɑˣ
keppi	Noun	ˈke̞pːi
keppihevonen	Noun	ˈke̞pːiˌhe̞ʋo̞ne̞n
keraamikko	Noun	ˈke̞rɑːmikːo̞
kerake	Noun	ˈkerɑke(ʔ)
kerettiläinen	Noun	ˈke̞re̞t̪ːiˌlæine̞n
kerho	Noun	ˈke̞rxo̞
keritä	Verb	ˈkeritæˣ
kerjetä	Verb	ˈkerjetæ(ʔ)
kerjäläinen	Noun	ˈkerjæˌlæinen
kerjäläismunkki	Noun	ˈkerjælæisˌmuŋkːi
kerma	Noun	ˈkermɑ
kermajuusto	Noun	ˈkermɑˌjuːsto
kermakakku	Noun	ˈke̞rmɑˌkɑkːu
kermavaahto	Noun	ˈke̞rmɑˌʋɑːxt̪o̞
kermaviili	Noun	ˈkermɑˌʋiːli
kerro	Verb	ˈkerːo(ʔ)
kerrossänky	Noun	ˈkerːosːæŋky
kerrostalo	Noun	ˈke̞rːo̞sˌt̪ɑlo̞
kerrottaneen	Verb	ˈkerːotːɑneːn
kerskakulutus	Noun	ˈkerskɑˌkulutus
kertausmerkki	Noun	ˈke̞rtɑusˌme̞rkːi
kertausta	Noun	ˈkertɑustɑ
kertoa	Verb	ˈkertoɑ
kertohedelmä	Noun	ˈkertoˌhedelmæ
kertoja	Noun	ˈkertojɑ
kertoma	Noun	ˈkertomɑ
kertosäe	Noun	ˈkertoˌsæe(ʔ)
kesi	Noun	ˈkesi
keskari	Noun	ˈke̞skɑri
keskeisvoima	Noun	ˈke̞ske̞isˌʋo̞imɑ
kesken	Adverb	ˈke̞ske̞n
keskenmeno	Noun	ˈkeskemˌmeno
keskenään	Adverb	ˈkeskenæːn
keskeyttää	Verb	ˈkeskeytːæː(ʔ)
keskialue	Noun	ˈke̞skiˌɑlu.e̞ˣ
keskijännite	Noun	cescijænːite
keskikohta	Noun	ˈkeskiˌkoxtɑ
keskimäärin	Adverb	ˈkeskimæːrin
keskimääräinen	Adjective	ˈkeskiˌmæːræinen
keskipakoisvoima	Noun	ˈke̞skiˌpɑko̞isˌʋo̞imɑ
keskituntiansio	Noun	ˈkeskiˌtuntiˌɑnsio
keskiviikko	Noun	ˈkeskiˌʋiːkːo
keskiyö	Noun	ˈkeskiˌyø̯
keskiö	Noun	ˈkeskiø
keskoskaappi	Noun	ˈkeskosˌkɑːpːi
keskus	Noun	ˈke̞skus
keskushermosto	Noun	ˈke̞skusˌhe̞rmo̞sto̞
keskussuoritin	Noun	ˈkeskusˌsuɔritin
keskusyksikkö	Noun	ˈkeskusˌyksikːø
kesy	Adjective	ˈkesy
kesä	Noun	ˈkesæ
kesäaika	Noun	ˈkesæˌɑi̯kɑ
kesähorros	Noun	ˈkesæˌxorːos
kesäitiö	Noun	ˈke̞sæˌit̪i.ø̞
kesämökki	Noun	ˈkesæˌmøkːi
kesäpuu	Noun	ˈkesæˌpuː
kesäpäivänseisaus	Noun	ˈkesæˌpæivænˌseisɑus
ketjukirje	Noun	ˈketjuˌkirje(ʔ)
ketkä	Pronoun	ˈketkæ
kettu	Noun	ˈt͡ʃʰɛʰtːʊ
ketunleipä	Noun	ˈketunˌleipæ
keuhkoahtaumatauti	Noun	ˈkeuhkoˌɑxtɑumɑˌtɑuti
keuhkofibroosi	Noun	ˈkeuhkoˌfibroːsi
keuhkoputkitulehdus	Noun	ˈkeuxʷkoˌputkiˌtulexdus
keuhkopöhö	Noun	ˈke̞uxkoˌpø̞ɦø̞
keveä	Adjective	ˈkeʋeæ
kevyehkö	Adjective	ˈkeʋyehkø
kevyt	Adjective	ˈkeʋyt
kevät	Noun	ˈkeʋæt
kevätpuu	Noun	ˈkeʋætˌpuː
kevätpäiväntasaus	Noun	ˈkevætˌpæivæntɑsɑus
keväämmällä	Adverb	ˈkeʋæːˌmːælːæ
keynesiläinen	Adjective	ˈkeynesiˌlæinen
keynesiläisyys	Noun	ˈkeynesiˌlæisyːs
khii	Noun	ˈkiː
kiasma	Noun	ˈkiɑsmɑ
kide	Noun	ˈkideˣ
kidus	Noun	ˈkidus
kiduskansi	Noun	ˈkidusˌkɑnsi
kidusrako	Noun	ˈkidusˌrɑko
kiduttaja	Noun	ˈkidutːɑjɑ
kiekonheitto	Noun	ˈkie̞ko̞nˌhe̞it̪ːo̞
kielari	Noun	ˈkielɑri
kieleke	Noun	ˈkielekeˣ
kieli	Noun	ˈkie̯li
kielipoliisi	Noun	ˈkieliˌpoliːsi
kielisoitin	Noun	ˈkieliˌsoitin
kielitaito	Noun	ˈkieliˌtɑito
kielletty	Adjective	ˈkielːetːy(ʔ)
kielsin	Verb	ˈkielsin
kieltää	Verb	ˈkieltæː(ʔ)
kiemura	Noun	ˈkiemurɑ
kierre	Noun	ˈkierːe(ʔ)
kierrätys	Noun	ˈkierːætys
kierteishäntämuurahaiskarhu	Noun	ˈkierteisˌhæntæˌmuːrɑɦɑisˌkɑrɦu
kiertokysely	Noun	ˈkie̞rt̪o̞ˌkyse̞ly
kiertoliittymä	Noun	ˈkiertoˌliːtːymæ
kiertäjänikama	Noun	ˈkiertæjæˌnikɑmɑ
kiertää	Verb	ˈkiertæː(ʔ)
kiertääkuinkissakuumaapuuroa	Phrase	ˈkie̞rtæːˈkːuiŋ ˈkisːɑ ˈkuːmɑː ˈpuːro̞.ɑ
kihara	Adjective	ˈkiɦɑrɑ
kiharapäinen	Adjective	ˈkiɦɑrɑˌpæinen
kihlaus	Noun	ˈkiç̞lɑus
kihti	Noun	ˈkiçti
kiihdyttää	Verb	ˈkiːhdytːæː
kiihottua	Verb	ˈkiːhotːuɑ(ʔ)
kiihotus	Noun	ˈkiːɦotus
kiihotuspuhe	Noun	ˈkiːɦotusˌpuɦeˣ
kiihtyvyys	Noun	ˈkiːhtyʋyːs
kiihtyä	Verb	ˈkiːhtyæ(ʔ)
kiikari	Noun	ˈkiːkɑri
kiila	Noun	ˈk̟iːlɑ
kiilata	Verb	ˈkiːlɑtɑˣ
kiille	Noun	ˈkiːlːeˣ
kiilua	Verb	ˈkiːluɑ(ʔ)
kiima	Noun	ˈkiːmɑ
kiina	Noun	ˈkiːnɑ
kiinankaali	Noun	ˈkiːnɑnˌkɑːli
kiinni	Adverb	ˈkiːnːiˣ
kiinnittää	Verb	ˈkiːnːitːæː(ʔ)
kiinteistö	Noun	ˈkiːn̪t̪e̞istø̞
kiinteä	Adjective	ˈkiːn̪t̪e̞æ
kiintoisa	Adjective	ˈkiːn̪t̪o̞isɑ
kiipeli	Noun	ˈkiːpeli
kiirastorstai	Noun	ˈkiːrɑsˌtorstɑi̯
kiire	Adjective	ˈkiːre̞ˣ
kiiruhtaa	Verb	ˈkiːruxt̪ɑːˣ
kiisi	Verb	ˈkiːsi
kiisseli	Noun	ˈkiːsːeli
kiistaton	Adjective	ˈkiːstɑton
kiitolaukka	Noun	ˈkiːtoˌlɑukːɑ
kiitollinen	Adjective	ˈkiːtolːinen
kiitollisuudenvelka	Noun	ˈkiːtolːisuːdenˌvelkɑ
kiitollisuus	Noun	ˈkiːtolːisuːs
kiitorata	Noun	ˈkiːtoˌrɑtɑ
kiitos	Interjection	ˈkiːt̪o̞s
kiitti	Interjection	ˈkiːtːi
kiittämättömyys	Noun	ˈkiːtːæˌmætːømyːs
kiittämätön	Adjective	ˈkiːtːæˌmætøn
kiittää	Verb	ˈkiːtːæː(ʔ)
kiitäjä	Noun	ˈkiːtæjæ
kiivas	Adjective	ˈkiːʋɑs
kilju	Noun	ˈkilju
kiljua	Noun	ˈkiljuɑ
kilkki	Noun	ˈkilkːi
kilowattituntimittari	Noun	ˈkiloˌʋɑttiˌtuntiˌmittɑri
kilpailla	Verb	ˈkilpɑilːɑ(ʔ)
kilpirauhanen	Noun	ˈkilpiˌrɑuɦɑnen
kilpukka	Noun	ˈkilpukːɑ
kimchi	Noun	ˈkimtʃi
kimmota	Verb	ˈkimːotɑ
kimpaantua	Verb	ˈkimpɑːn̪t̪uɑˣ
kimppuun	Noun	ˈkimpːuːn
kina	Noun	ˈkɪna
kinnas	Noun	ˈkinːɑs
kinos	Noun	ˈkino̞s
kippis	Interjection	ˈkipːis
kirahvi	Noun	ˈkirɑhʋi
kirejä	Noun	ˈkirejæ
kiri	Noun	ˈkiri
kirien	Noun	ˈkirien
kiriin	Noun	ˈkiriːn
kiriksi	Noun	ˈkiriksi
kirille	Noun	ˈkirilːe
kirillä	Noun	ˈkirilːæ
kiriltä	Noun	ˈkiriltæ
kirinä	Noun	ˈkirinæ
kirissä	Noun	ˈkirisːæ
kiristyä	Verb	ˈkiristyæ(ʔ)
kiristää	Verb	ˈkiristæː
kirittä	Noun	ˈkiritːæ
kiriä	Noun	ˈkiriæˣ
kirja	Noun	ˈkirjɑ
kirjallinen	Adjective	kirjɑlːinen
kirjallisuus	Noun	ˈkirjɑlːisuːs
kirjanpito	Noun	ˈkirjɑmˌpito
kirjasin	Noun	ˈkirjɑsin
kirje	Noun	ˈkirjeˣ
kirjeenvaihto	Noun	ˈkirje̞ːnˌʋɑiçt̪o̞
kirjeineen	Noun	ˈkirjeineːn
kirjeitse	Adverb	ˈkirjei̯tseˣ
kirjo	Noun	ˈkirjo
kirjoa	Verb	ˈkirjo̞ɑˣ
kirjoineen	Noun	ˈkirjoineːn
kirjoitelma	Noun	ˈkirjoitelmɑ
kirjoitin	Noun	ˈkirjo̞it̪in
kirjoittaa	Verb	ˈkirjoi̯tːɑːˣ
kirjokansi	Noun	ˈkirjoˌkɑnsi
kirjolohi	Noun	ˈkirjo̞ˌlo̞ɦi
kirkas	Adjective	ˈkirkɑs
kirkkovene	Noun	ˈkirkːo̞ˌʋe̞ne̞
kirkonaika	Noun	ˈkirkonɑi̯kɑ
kirkua	Verb	ˈkirkuɑ(ʔ)
kirmailu	Noun	ˈkirmɑilu
kirnu	Noun	ˈkirnu
kiroilla	Verb	ˈkiroilːɑ(ʔ)
kirota	Verb	ˈkirotɑ(ʔ)
kirous	Noun	ˈkirous
kirpputori	Noun	ˈkirpːuˌtori
kirsi	Noun	ˈkirsi
kirsikka	Noun	ˈkirsikːɑ
kirsu	Noun	ˈkirsu
kirurgi	Noun	ˈkirurɡi
kirveli	Noun	ˈkirʋeli
kissa	Noun	ˈkisːɑ
kissanmaito	Noun	ˈkisːɑnˌmɑito
kissatappelu	Noun	ˈkisːɑˌtɑpːelu
kisu	Verb	ˈkisu
kita	Noun	ˈkitɑ
kitara	Noun	ˈkitɑrɑ
kitarisa	Noun	ˈkitɑˌrisɑ
kitkeä	Verb	ˈkitkæɑ(ʔ)
kitsi	Noun	ˈkitsi
kitua	Verb	ˈkituɑ(ʔ)
kiuas	Noun	ˈkiuwːɑs
kiulukka	Noun	ˈkiulukːɑ
kiva	Noun	ˈkiʋɑ
kivi	Noun	ˈkiʋi
kivisolu	Noun	ˈkiʋiˌsolu
kivulias	Adjective	ˈkiʋuliɑs
klaava	Noun	ˈklɑːʋɑ
klavesiini	Noun	ˈklɑʋesiːni
klemmari	Noun	ˈkle̞mːɑri
klusiili	Noun	ˈklusiːli
klyysi	Noun	ˈklyːsi
knalli	Noun	ˈknɑlːi
kobra	Noun	kɔbra
koe	Noun	ku
koeaika	Noun	ˈkoeʔʔˌɑikɑ
koeajo	Noun	ˈkoeʔʔˌɑjo
koetella	Verb	ˈkoetelːɑ(ʔ)
koettaa	Verb	ˈkoetːɑː(ʔ)
kofeiinitabletti	Noun	ˈkofeiːniˌtɑbletːi
kofeiiniton	Adjective	ˈko̞fe̞.iːˌnit̪o̞n
kofunktio	Noun	ˈkofuŋktio
koggi	Noun	ˈkoɡːi
kognitiotiede	Noun	ˈkoɡnitioˌtiede
kohdata	Verb	ˈkoɦdɑtɑ(ʔ)
kohdella	Verb	ˈko̞xde̞lːɑˣ
kohdentaminen	Noun	ˈkoxdentɑˌminen
kohdunkaula	Noun	ˈkoxduŋˌkɑulɑ
kohina	Noun	ˈkoɦinɑ
kohme	Noun	ˈkoxmeˣ
kohokartta	Noun	ˈkoɦoˌkɑrtːɑ
kohota	Verb	ˈkohotɑˣ
kohta	Noun	ˈko̞ht̪ɑ
kohtalaisesti	Adverb	ˈkoxtɑlɑiˌsesti
kohtalokkaasti	Adverb	ˈkoxtɑloˌkːɑːsti
kohtuullinen	Adjective	ˈkoxtuːlːinen
kohu	Noun	ˈkohu
koi	Noun	kɔɪ
koillinen	Noun	ˈkoilːinen
koipeliini	Noun	ˈkoipeliːni
koira	Noun	ˈkoi̯rɑ
koiranpentu	Noun	ˈkoirɑnˌpentu
koisi	Verb	ˈko̞isi
koitettava	Verb	ˈkoitetːɑʋɑ
koittaa	Verb	ˈkoi̯tːɑː
koitua	Verb	ˈkoituɑ(ʔ)
koivu	Noun	ˈkoiʋu
koivusokeri	Noun	ˈkoiʋuˌsokeri
koje	Noun	ˈkoje
kokata	Verb	ˈkokɑtɑ(ʔ)
kokea	Verb	ˈkokeɑ(ʔ)
kokeellinen	Adjective	ˈkokeːlːinen
kokeilla	Noun	ˈkokeilːɑ
kokka	Noun	ˈkokːɑ
kokki	Noun	ˈkokːi
kokolattiamatto	Noun	ˈko̞ko̞ˌlɑt̪ːiɑˌmɑt̪ːo̞
kokonainen	Adjective	ˈkokoˌnɑinen
kokonaisvaltainen	Adjective	ˈkokonɑisˌvɑltɑinen
koksiitti	Noun	ˈkoksiːtːi
koktaili	Noun	ˈko̞kt̪ɑili
kolahtaa	Verb	ˈko̞lɑxt̪ɑːˣ
kolesteroli	Noun	ˈkolesteroli
kolkuttaa	Verb	ˈko̞lkut̪ːɑːˣ
kollaboraatio	Noun	ˈkolːɑboˌrɑːtio
kollari	Noun	ˈko̞lːɑri
kolme	Numeral	ˈkolme
kolmesataa	Numeral	ˈkolmeˌsɑtɑː
kolmetoista	Numeral	ˈkolmeˌtoi̯stɑ
kolmiloikka	Noun	ˈko̞lmiˌlo̞ikːɑ
kolmio	Noun	ˈkolmio
kolmivaihekilowattituntimittari	Noun	ˈkolmiˌʋɑiɦeˌkːiloˌwɑtːiˌtuntiˌmitːɑri
kolmivaihevirta	Noun	ˈkolmiˌʋɑiɦeˌʋːirtɑ
kolofoni	Noun	ˈkolofoni
kololintu	Noun	ˈkoloˌlintu
kolopuu	Noun	ˈkoloˌpuː
kolpakko	Noun	ˈko̞lpɑkːo̞
kolpakot	Noun	ˈko̞lpɑko̞t̪
kolvi	Noun	ˈkolʋi
komeetta	Noun	ˈko̞me̞ːt̪ːɑ
komentaa	Verb	ˈko̞me̞n̪t̪ɑː(ʔ)
komento	Noun	ˈko̞me̞n̪t̪o̞
komentokehote	Noun	ˈko̞me̞n̪t̪o̞ˌke̞ɦo̞t̪e̞(ʔ)
komentosarja	Noun	ˈko̞me̞n̪t̪o̞ˌsɑrjɑ
komitea	Noun	ˈkomiteɑ
kondensaattori	Noun	ˈko̞nde̞nsɑːt̪ːo̞ri
kone	Noun	koːnə
koneet	Noun	ˈko̞ne̞ːt̪
konjakki	Noun	ˈkonjɑkːi
konsertti	Noun	ˈkonsertːi
kontti	Noun	ˈkontːi
koo	Noun	ˈkoː
koolapuu	Noun	ˈkoːlɑˌpuː
kooma	Noun	ˈkoːmɑ
kopaus	Noun	ˈkopɑus
kopeekka	Noun	ˈkopeːkːɑ
kopoti	Interjection	ˈkoˑpoˑt̪i
koppa	Noun	ˈkopːɑ
koppi	Noun	ˈko̞pːi
koppisiemeninen	Noun	ˈkopːiˌsiemeninen
koputus	Noun	ˈkoputus
koralli	Noun	ˈkorɑlːi
kore	Noun	ˈkɔəɹeɪ
korintti	Noun	ˈkorintːi
koristaa	Verb	ˈko̞ristɑːˣ
koriste	Noun	ˈko̞riste̞ˣ
koristella	Verb	ˈko̞riste̞lːɑˣ
korjata	Verb	ˈkorjɑtɑ(ʔ)
korkein	Adjective	ˈkorkein
korkeinhallintooikeus	Noun	ˈkorkein ˈhɑlːintoˌoikeus
korkeinoikeus	Noun	ˈkorkein ˈoikeus
korkeushyppy	Noun	ˈko̞rke̞usˌcypːy
korkkihuokonen	Noun	ˈkorkːiˌxuokonen
korkkijälsi	Noun	ˈkorkːiˌjælsi
korpus	Noun	ˈkorpus
korsetti	Noun	ˈko̞rse̞t̪ːi
korsikanritari	Noun	ˈko̞rsikɑn̪ˌrit̪ɑri
kortsu	Noun	ˈkortsu
korva	Noun	ˈkorʋɑ
korvake	Noun	ˈkorʋɑke(ʔ)
korvaketuppi	Noun	ˈkorʋɑkeˌtupːi
korvata	Verb	ˈko̞rʋɑt̪ɑ(ʔ)
kosia	Verb	ˈko̞si.ɑˣ
koskea	Noun	ˈkoskeɑ
kosketa	Verb	ˈkosketɑˣ
kostaa	Verb	ˈkostɑː(ʔ)
kostaja	Noun	ˈkostɑjɑ
kosto	Noun	ˈkosto
kostuttaa	Verb	ˈko̞stut̪ːɑːˣ
kotelo	Noun	ˈkotelo
koteloitiö	Noun	ˈkoteloˌitiø
koteloitua	Verb	ˈko̞t̪e̞lo̞it̪uɑˣ
kotelomalja	Noun	ˈkoteloˌmɑljɑ
kotelopalko	Noun	ˈkoteloˌpɑlko
kotelopallo	Noun	ˈkoteloˌpɑlːo
kotelopullo	Noun	ˈkoteloˌpulːo
kotelorakko	Noun	ˈkoteloˌrɑkːo
kotimaa	Noun	ˈkotiˌmɑː
kotimainen	Adjective	ˈkotiˌmɑinen
kotiutua	Verb	ˈkotiutuɑˣ
kotkansiipi	Noun	ˈkotkɑnˌsiːpi
koukku	Noun	ˈkou̯kːu
koulia	Verb	ˈkouliɑˣ
kouluratsastus	Noun	ˈkouluˌrɑtsɑstus
kouristus	Noun	ˈkouristus
koutsi	Noun	ˈkoutsi
kovakallo	Noun	ˈkoʋɑˌkɑlːo
kovempi	Adjective	ˈkoʋempi
kovera	Adjective	ˈko̞ʋe̞rɑ
koveri	Noun	ˈko̞ʋe̞ri
koversini	Noun	ˈkoʋerˌsini
kovin	Adverb	ˈkoʋin
kowari	Noun	ˈko̞ʋɑri
krapula	Noun	ˈkrɑpulɑ
kravatti	Noun	ˈkrɑʋɑt̪ːi
kreationisti	Noun	ˈkreɑtioˌnisti
kreikatar	Noun	ˈkre̞ikɑt̪ɑr
krematoida	Verb	ˈkremɑˌtoidɑ(ʔ)
kreolikieli	Noun	ˈkre̞.o̞liˌkie̞li
kriisi	Noun	ˈkriːsi
kriisiapu	Noun	ˈkriːsiˌɑpu
krillihylje	Noun	ˈkrilːiˌhylje̞ˣ
kristalli	Noun	ˈkristɑlːi
kristitty	Noun	ˈkristitty
kroissantti	Noun	ˈkro̞isːɑn̪t̪ːi
krokaani	Noun	ˈkrokɑːni
kronologia	Noun	ˈkronoloɡiɑ
kroppa	Noun	ˈkro̞pːɑ
kruunu	Noun	ˈkruːnu
ksii	Noun	ˈksiː
ksylitoli	Noun	ˈksylitoli
kudo	Noun	ˈkudoˣ
kudosneste	Noun	ˈkudo̞sˌne̞ste̞ˣ
kuha	Noun	ˈkuhɑ
kuhankeittäjä	Noun	ˈkuɦɑnˌke̞it̪ːæjæ
kuhnia	Verb	ˈkuhniɑˣ
kuhnuri	Noun	ˈkuxnuri
kuhun	Pronoun	ˈkuhun
kuiden	Noun	ˈkuiden
kuikka	Noun	ˈkuikːɑ
kuikui	Noun	ˈkuikui
kuilu	Noun	ˈkuilu
kuisti	Noun	ˈkuisti
kuitten	Noun	ˈkuitːen
kuitti	Noun	ˈkuit̪ːi
kuitu	Noun	ˈkuitu
kuivakkokasvi	Noun	ˈkuiʋɑkːoˌkɑsʋi
kuivua	Verb	ˈkui̯ʋuɑˣ
kuivuus	Noun	ˈkuivuːs
kuka	Pronoun	ˈkukɑ
kukaan	Pronoun	ˈkukɑːn
kukinta	Noun	ˈkukin̪t̪ɑ
kukinto	Noun	ˈkukinto
kukka	Verb	ˈkʰʊʰkːa
kukkakaali	Noun	ˈkukːɑˌkɑːli
kukkapohjus	Noun	ˈkukːɑˌpoxjus
kukkia	Noun	ˈkukːi.ɑ
kukko	Noun	ˈkukːo
kukkokello	Noun	ˈkukːoˌkelːo
kukkua	Verb	ˈkukːuɑ(ʔ)
kuksi	Pronoun	ˈkuksi
kuksia	Noun	ˈkuksi.ɑ
kulho	Noun	ˈkulho
kuljen	Verb	ˈkulje̞n
kuljeskelu	Noun	ˈkuljeskelu
kulkea	Verb	ˈkulkeɑ(ʔ)
kulkija	Noun	ˈkulkiɑ
kulkue	Noun	ˈkulkue(ʔ)
kulkulupa	Noun	ˈkulkuˌlupɑ
kulkutie	Noun	ˈkulkuˌtie
kulla	Noun	ˈkulːɑ
kulle	Pronoun	ˈkulːe(ʔ)
kulli	Noun	ˈkulːi
kulmahiomakone	Noun	ˈkulmɑˌç̞iomɑˌkone(ʔ)
kulmakarva	Noun	ˈkulmɑˌkɑrʋɑ
kulmakynä	Noun	ˈkulmɑˌkynæ
kulmikas	Adjective	ˈkulmikɑs
kulo	Noun	ˈkulo
kulon	Noun	ˈkulon
kulorastas	Noun	ˈkuloˌrɑstɑs
kulta	Noun	ˈkultɑ
kultainen	Adjective	ˈkul̪t̪ɑine̞n
kultaiset	Adjective	ˈkul̪t̪ɑiset̪
kultaleijonatamariini	Noun	ˈkultɑˌleijonɑˌtɑmɑriːni
kultarinta	Noun	ˈkultɑˌrintɑ
kultaseppä	Noun	ˈkultɑˌsepːæ
kultsi	Noun	ˈkultsi
kultti	Noun	ˈkultːi
kulua	Verb	ˈkuluɑ(ʔ)
kuluttaa	Verb	ˈkulutːɑː(ʔ)
kumma	Adjective	ˈkumːɑ
kummitustalo	Noun	ˈkumːitusˌtɑlo
kummuta	Verb	ˈkumːutɑ(ʔ)
kumpuilla	Verb	ˈkumpuilːɑ(ʔ)
kuna	Noun	ˈkuna
kungfu	Noun	ˈkuŋːfuː
kuningas	Noun	ˈkuninɡ̊ɑs
kuningaskobra	Noun	ˈkun̪iŋːɑsˌko̞brɑ
kuningaskunta	Noun	ˈkuniŋːɑsˌkun̪t̪ɑ
kuningatar	Noun	ˈkuniŋːɑt̪ɑr
kuninkaan	Noun	ˈkuniŋkɑːn
kunka	Pronoun	ˈkuŋkɑ
kunnas	Noun	ˈkunːɑs
kunpa	Interjection	ˈkumpɑ
kunta	Noun	ˈkʰʊn̥ta
kuntoilla	Verb	ˈkun̪t̪o̞ilːɑˣ
kuntoilu	Noun	ˈkuntoilu
kuohu	Noun	ˈkuoɦu
kuohukerma	Noun	ˈkuoɦuˌkermɑ
kuokka	Noun	ˈkuo̞kːɑ
kuola	Noun	ˈkuɔlɑ
kuolemanhalu	Noun	ˈkuɔlemɑnˌhɑlu
kuolevainen	Adjective	ˈkuoleˌvɑinen
kuoli	Verb	ˈkuoli
kuolio	Noun	ˈkuolio
kuolla	Verb	ˈkuo̯lːɑˣ
kuollen	Verb	kuolːen
kuoma	Noun	ˈkuomɑ
kuori	Noun	ˈkuɔri
kuoria	Verb	ˈkuoriɑˣ
kuormaauto	Noun	ˈkuo̯rmɑˌɑu̯to
kuorsata	Verb	ˈkuɔrsɑt̪ɑˣ
kuorta	Noun	ˈkuɔrtɑ
kuovi	Noun	ˈkuoʋi
kupera	Adjective	ˈkupe̞rɑ
kuperkeikka	Noun	ˈkupe̞rke̞ikːɑ
kupla	Noun	ˈkuplɑ
kureliivi	Noun	ˈkureˌlːiːʋi
kuri	Noun	ˈkuri
kurja	Adjective	ˈkurjɑ
kurjenpolvi	Noun	ˈkurjemˌpolʋi
kurki	Noun	ˈkurki
kurkkia	Verb	ˈkurkːi.ɑˣ
kurkku	Noun	ˈkurkːu
kurkkumätä	Noun	ˈkurkːuˌmætæ
kurkuma	Noun	ˈkurkuma
kurlata	Verb	ˈkurlɑtɑ
kuroa	Verb	ˈkuroɑˣ
kuroi	Verb	ˈkuroi̯
kurpitsa	Noun	ˈkurpitsɑ
kurssi	Noun	ˈkursːi
kurttukaali	Noun	ˈkurtːuˌkɑːli
kurut	Noun	ˈkurut̪
kusi	Noun	ˈkusi
kuskus	Noun	ˈkuskus
kussa	Pronoun	ˈkusːɑ
kusta	Verb	ˈkustɑˣ
kuta	Pronoun	ˈkutɑ
kutea	Verb	ˈkuteɑ(ʔ)
kuten	Adverb	ˈkuten
kutenka	Adverb	ˈkuteŋkɑ
kutikula	Noun	ˈkutikulɑ
kutistaa	Verb	ˈkutistɑː
kutistua	Verb	ˈkut̪istuɑˣ
kutka	Pronoun	ˈkutkɑ
kutsua	Verb	ˈkutsuɑˣ
kutta	Verb	ˈkutːɑ
kuttu	Noun	ˈkut̪ːu
kutu	Noun	ˈkutu
kuu	Noun	ˈkuː
kuukausi	Noun	ˈkuːˌkɑu̯si
kuukausipalkka	Noun	ˈkuːkɑusiˌpɑlkːɑ
kuukautiset	Adjective	ˈkuːkɑutinen
kuukkeli	Noun	ˈkuːkːeli
kuule	Noun	ˈkuːle̞ˣ
kuuli	Verb	ˈkuːli
kuuliainen	Adjective	ˈkuːliɑinen
kuuliaisesti	Adverb	ˈkuːliˌɑisesti
kuulla	Verb	ˈkuːlːɑˣ
kuullen	Verb	kuːlːen
kuullottaa	Verb	ˈkuːlːot̪ːɑː(ʔ)
kuulovammainen	Noun	ˈkuːloˌʋɑmːɑinen
kuultokuva	Noun	ˈkuːltoˌkuʋɑ
kuulua	Verb	ˈkuːluɑˣ
kuuluisuus	Noun	ˈkuːluisuːs
kuuma	Adjective	ˈkuːmɑ
kuume	Noun	ˈkuːme(ʔ)
kuunari	Noun	ˈkuːnɑri
kuunnella	Verb	ˈkuːnːelːɑˣ
kuunnellen	Verb	ˈkuːnːelːen
kuunpimennys	Noun	ˈkuːmˌpimenːys
kuura	Noun	ˈkuːrɑ
kuuri	Noun	ˈkuːri
kuuromykkä	Noun	ˈkuːroˌmykːæ
kuurous	Noun	ˈkuːrous
kuusi	Numeral	ˈkuːsi
kuusikulmio	Noun	ˈkuːsiˌkulmio
kuusio	Noun	ˈkuːsio
kuutamo	Noun	ˈkuːt̪ɑmo̞
kuutio	Noun	ˈkuːtio
kuutti	Noun	ˈkuːtːi
kuva	Noun	ˈkuʋɑ
kuvailla	Verb	ˈkuvɑilːɑ(ʔ)
kuvake	Noun	ˈkuʋɑke̞(ʔ)
kuvankäsittely	Noun	ˈkuʋɑŋˌkæsitːely
kuvanlukija	Noun	ˈkuʋɑn̪ˌlukijɑ
kuvapiste	Noun	ˈkuʋɑˌpiste̞ˣ
kuvaputki	Noun	ˈkuʋɑˌput̪ki
kuvata	Verb	ˈkuvɑtɑ(ʔ)
kuvaus	Noun	ˈkuʋɑus
kuvausjoukko	Noun	ˈkuʋɑusˌjoukːo
kuve	Noun	ˈkuʋe̞
kuvitella	Verb	ˈkuvitella
kuvitellen	Verb	ˈkuvitelːen
kuvittaa	Verb	ˈkuʋit̪ːɑː
kuvittaminen	Noun	ˈkuʋitːɑˌminen
kuvituskuva	Noun	ˈkuʋitusˌkuʋɑ
kvartsi	Noun	ˈkʋɑrtsi
kvasaari	Noun	ˈkʋɑsɑːri
kveekari	Noun	ˈkʋeːkɑri
kvitteni	Noun	ˈkvitːeni
kyberavaruus	Noun	ˈkyberˌɑʋɑruːs
kyetä	Verb	ˈkyetæ(ʔ)
kyhätä	Verb	ˈkyɦæt̪æˣ
kyllästys	Noun	ˈkylːæstys
kylmästi	Adverb	ˈkylmæstiˣ
kylpyamme	Noun	ˈkylpyˌɑmːe̞ˣ
kylpyankka	Noun	ˈkylpyˌɑŋkːɑ
kyläbulbuli	Noun	ˈkylæˌbulbuli
kymmenesosasekunti	Noun	ˈkymːenesosɑˌsekunti
kymmenjärjestelmä	Noun	ˈkymːenˌjærjestelmæ
kymmensormijärjestelmä	Noun	ˈkymːenˌsormiˌjærjesˌtelmæ
kymri	Noun	ˈkymri
kynimättä	Verb	ˈkynimætːæ
kynittävänä	Verb	ˈkynitːæʋænæ
kyniä	Noun	ˈkyniæ
kynnetön	Adjective	ˈkynːe̞t̪ø̞n
kynnetönmanaatti	Noun	ˈkynːetøˌmːɑnɑːtːi
kynsi	Noun	ˈkynsi
kynsilakka	Noun	ˈkynsiˌlɑkːɑ
kynsilaukka	Noun	ˈkynsiˌlɑukːɑ
kynsinauha	Noun	ˈkynsiˌnɑuɦɑ
kynsinjahampain	Adverb	ˈkynsin jɑ ˈhɑmpɑin
kynsivalli	Noun	ˈkynsiˌʋɑlːi
kynsiä	Noun	ˈkynsiæ
kynteli	Noun	ˈkynteli
kynttilä	Noun	ˈkyn̪t̪ːilæ
kynä	Noun	ˈkynæ
kypärä	Noun	ˈkypæræ
kyrpiä	Noun	ˈkyrpi.æ
kyse	Noun	ˈkyse
kyssäkaali	Noun	ˈkysːæˌkɑːli
kysta	Noun	ˈkystɑ
kysymysmerkki	Noun	ˈkysymysˌmerkːi
kysyä	Verb	ˈkysyæˣ
kyteä	Verb	ˈkyteæ(ʔ)
kytkyt	Noun	ˈkyt̪kyt̪
kytkös	Noun	ˈkyt̪ˑkøs
kyttä	Noun	ˈkyt̪ːæ
kyvyttömyys	Noun	ˈkyʋytːømyːs
kyy	Noun	ˈkyː
kyykistyä	Verb	ˈkyːkistyæˣ
kyynelrauhanen	Noun	ˈkyːnelˌrɑuɦɑnen
kyynärpää	Noun	ˈkyːnærˌpæː
kyynärä	Noun	ˈkyːnæræ
kyyttö	Noun	ˈkyːtːø
käden	Noun	ˈkæden
kädestäennustaminen	Noun	ˈkædestæˌenːustɑminen
käenkaali	Noun	ˈkæenˌkɑːli
käki	Noun	ˈkæki
käkikello	Noun	ˈkækiˌkelːo
käly	Noun	ˈkæly
kämmekkä	Noun	ˈkæmːekːæ
kämmen	Noun	ˈkæmːen
kämppis	Noun	ˈkæmpːis
kämppä	Noun	ˈkæmpːæ
känni	Noun	ˈkænːi
kännykkä	Noun	ˈkænːykːæ
käpsä	Noun	ˈkæpsæ
käpykaarti	Noun	ˈkæpyˌkɑːrti
käpykaartilainen	Noun	ˈkæpyˌkɑːrtilɑinen
käpälä	Noun	ˈkæpælæ
kärhi	Noun	ˈkærɦi
kärki	Noun	ˈkærki
kärkikasvupiste	Noun	ˈkærkiˌkɑsʋuˌpiste(ʔ)
kärsivällinen	Adjective	ˈkærsivælːinen
kärsivällisyys	Noun	ˈkærsiˌʋælːisyːs
kärsiä	Noun	ˈkærsiæ
kärsä	Noun	ˈkærsæ
kärsäkäs	Noun	ˈkærsækæs
kärsäkäsmäinen	Noun	ˈkærsækæsˌmæinen
käräjäoikeus	Noun	ˈkæræjæˌoikeus
käräjäpaikka	Noun	ˈkæræjæˌpɑikːɑ
käräjöidä	Verb	ˈkæræjøidæ(ʔ)
käsi	Noun	ˈkæsi
käsiase	Noun	ˈkæsiˌɑse(ʔ)
käsikirja	Noun	ˈkæsiˌkirjɑ
käsikosketus	Noun	ˈkæsiˌkosketus
käsipallo	Noun	ˈkæsiˌpɑlːo
käsite	Noun	ˈkæsit̪e̞ˣ
käsitellä	Verb	ˈkæsitelːæ(ʔ)
käsitellään	Verb	ˈkæsitelːæːn
käsiteltävyys	Noun	ˈkæsiteltæˌʋyːs
käsittely	Noun	ˈkæsitːely
käsittää	Verb	ˈkæsitːæː(ʔ)
käsitys	Noun	ˈkæsit̪ys
käskeä	Verb	ˈkæskeæˣ
käsky	Noun	ˈkæsky
kätellä	Verb	ˈkætelːæ(ʔ)
kätkyt	Noun	ˈkæt̪kyt̪
kävellä	Verb	ˈkæʋelːæˣ
kävelläunissaan	Verb	ˈkæʋelːæ(ʔ) ˈunisːɑːn
kävely	Noun	ˈkæʋe̞ly
kävelykansi	Noun	ˈkæʋelyˌkɑnsi
käy	Verb	ˈkæy
käydä	Verb	ˈkæy̯dæˣ
käydäkaupaksi	Verb	ˈkæydæˣ ˈkːɑupɑksi
käydäkierroksilla	Verb	ˈkæydæˣ ˈkierːoksilːa(ʔ)
käydäkimppuun	Verb	ˈkæydæˣ ˈkːimpːuːn
käydäkimppuunkuinsikalimppuun	Verb	ˈkæydæ ˈkːimpːuːn ˈkuin ˈsikɑ ˈlimpːuːn
käydäläpi	Verb	ˈkæydæˣ ˈlːæpi
käydäoikeutta	Verb	ˈkæydæˣ ˈoikeutːɑ
käydäpäinsä	Verb	ˈkæydæˣ ˈpːæinsæ(ʔ)
käydäpäälle	Verb	ˈkæydæˣ ˈpːælːe(ʔ)
käyrätorvi	Noun	ˈkæyræˌtorʋi
käyttäjä	Noun	ˈkæytːæjæ
käyttäytyä	Verb	ˈkæy̯tːæy̯tyæˣ
käyttää	Verb	ˈkæy̯tːæːˣ
käyttö	Noun	ˈkæytːø
käytännöllinen	Adjective	ˈkæyt̪æn̪ːø̞lːin̪e̞n̪
käytäntö	Noun	ˈkæyt̪æn̪t̪ø̞
käytös	Noun	ˈkæytøs
käämi	Noun	ˈkæːmi
käännellä	Verb	ˈkæːnːelːæ(ʔ)
kääntyä	Verb	ˈkæːntyæˣ
kääntää	Verb	ˈkæːntæː(ʔ)
kääpiö	Noun	ˈkæːpiø
kääpä	Noun	ˈkæːpæ
kääre	Noun	ˈkæːre̞ˣ
kääriäinen	Noun	ˈkæːriæinen
käärme	Noun	ˈkæːrmeˣ
käärmeenlumooja	Noun	ˈkæːrme̞ːnˌlumo̞ːjɑ
käärökärsäkäs	Noun	ˈkæːrøˌkærsækæs
köli	Noun	ˈkøli
köngäs	Noun	ˈkøŋːæs
köyhyys	Noun	ˈkøyhyːs
köyhä	Adjective	ˈkøy̯hæ
köysimäinen	Adjective	ˈkøysiˌmæinen
lassie	Noun	ˈlæsi
lasta	Adjective	ˈlasta
lastu	Noun	ˈlɑstu
lastua	Noun	ˈlɑstuɑ
latauspuikko	Noun	ˈlɑtɑusˌpuikːo
lato	Noun	ˈlɑt̪o
lattea	Adjective	ˈlɑtːe̞ɑ
lattia	Noun	ˈlɑtːiɑ
latu	Noun	ˈlɑtu
latvialainen	Noun	ˈlɑtviɑlɑinen
lauantai	Noun	ˈlɑuɑn̪t̪ɑi
laukaisin	Noun	ˈlɑukɑisin
laukaisuteline	Noun	ˈlɑukɑisuˌtelineˣ
laukka	Noun	ˈlɑukːɑ
laukullinen	Noun	ˈlaukulːinen
laulu	Noun	ˈlɑu̯lu
lauma	Noun	ˈlɑu̯mɑ
laupiaan	Adjective	ˈlɑupiɑːn
lause	Noun	ˈlɑuseˣ
lauseenvastike	Noun	ˈlɑu.seːnˌvɑs.ti.ke(ʔ)
lausua	Verb	ˈlɑusuɑ(ʔ)
lauttaa	Noun	ˈlɑutːɑː
lavastaja	Noun	ˈlɑʋɑstɑjɑ
lavuaari	Noun	ˈlɑʋuɑːri
ledi	Noun	ˈledi
leffa	Noun	ˈlefːɑ
lego	Noun	ˈleɡo
lehden	Noun	ˈleçden
lehdessä	Noun	ˈlehdesːæ
lehtiruoti	Noun	ˈlehtiˌruoti
lehtitaikina	Noun	ˈlehtiˌtɑikinɑ
leihin	Noun	ˈleihin
leijuri	Noun	ˈleiuri
leikata	Verb	ˈleikɑt̪ɑ(ʔ)
leike	Noun	ˈle̞ike̞(ʔ)
leikkaaja	Noun	ˈlei̯kːɑːjɑ
leikki	Noun	ˈleikːi
leikkipuisto	Noun	ˈleikːiˌpuisto
leikkiä	Verb	ˈle̞ikːi.æˣ
leili	Noun	ˈleili
leima	Noun	ˈleimɑ
leimahtaa	Verb	ˈleimɑxtɑːˣ
leino	Adjective	ˈleino
leipä	Noun	ˈlei̯pæ
leiri	Noun	ˈleiri
leissä	Noun	ˈleisːæ
leiviskä	Noun	ˈlei.vis.kæ
lelliä	Verb	ˈlelːiæ
lelu	Noun	ˈlelu
lemma	Noun	ˈlɛmə
lempinimi	Noun	ˈlempiˌnimi
lempiä	Noun	ˈle̞mpi.æ
lemu	Verb	ˈlemu
leninki	Noun	ˈleniŋki
lento	Adjective	ˈlento
lentoemäntä	Noun	ˈlentoˌemæntæ
lentokonesuoja	Noun	ˈlentoˌkoneˌsːuɔjɑ
lentopallo	Noun	ˈle̞n̪t̪o̞ˌpɑlːo̞
lentää	Verb	ˈlentæːˣ
leopardi	Noun	ˈle̞o̞ˌpɑrdi
lepakko	Noun	ˈlepɑkːo
lepo	Noun	ˈlepo
lepoitiö	Noun	ˈlepoˌitiø
lepomassa	Noun	ˈlepoˌmɑsːɑ
leposide	Noun	ˈlepoˌsideˣ
leposyke	Noun	ˈlepoˌsyke(ʔ)
lepovuosi	Noun	ˈlepoˌʋuɔsi
leppäkerttu	Noun	ˈlepːæˌkertːu
lesbo	Noun	ˈlɛzbəʊ
leskenlehti	Noun	ˈleskenˌlehti
letku	Noun	ˈlet̪ku
letti	Noun	ˈlet̪ːi
lettu	Noun	ˈletːu
leuku	Noun	ˈle̞uku
levensi	Verb	ˈle̞ʋe̞nsi
leveys	Noun	ˈle̞ʋe̞ys
leveysaste	Noun	ˈle̞ʋe̞ysˌɑste̞ˣ
levinneisyysalue	Noun	ˈleʋinːeisyːsˌɑlue
leviäin	Noun	ˈleviæin
levottomuus	Noun	ˈleʋotːomuːs
levykuva	Noun	ˈleʋyˌkuʋɑ
levyttää	Verb	ˈle̞ʋyt̪ːæːˣ
levä	Noun	ˈleʋæ
levähdys	Noun	ˈle̞ʋæcdys
levähtää	Verb	ˈle̞ʋæctæː
levätä	Verb	ˈleʋæt̪æ(ʔ)
libertarismi	Noun	ˈlibertɑrismi
liene	Verb	ˈliene(ʔ)
liete	Verb	ˈliet̪e̞ˣ
liettualainen	Noun	ˈlietːuɑˌlɑinen
lieve	Adjective	ˈlie̞ʋe̞
liha	Noun	ˈliɦɑ
lihamureke	Noun	ˈliɦɑˌmure̞ke̞ˣ
lihapulla	Noun	ˈliɦɑˌpulːɑ
lihas	Noun	ˈlihɑs
lihassyy	Noun	ˈliɦɑsˌsyː
lihava	Adjective	ˈlihɑʋɑ
lihavoida	Verb	ˈlihɑvoidɑ(ʔ)
lihoa	Verb	ˈliɦoɑ
lihottaa	Verb	ˈlihotːɑː
liika	Noun	ˈliːkɑ
liikahtaa	Verb	ˈliːkɑxt̪ɑːˣ
liike	Noun	ˈliːke(ʔ)
liikenneympyrä	Noun	ˈliːkenːeʔˌympyræ
liikkua	Verb	ˈliːkːuɑˣ
liiku	Verb	ˈliːkuˣ
liikuttava	Adjective	liːkutːɑvɑ
liima	Noun	ˈliːmɑ
liioittelu	Noun	ˈliːoitːelu
liisi	Verb	ˈliːsi
liite	Noun	ˈliːteˣ
liiteri	Noun	ˈliːteri
liitin	Noun	ˈliːtin
liitti	Verb	ˈliːtːi
liitto	Noun	ˈliːtːo
liittymä	Noun	ˈliːtːymæ
liittyä	Verb	ˈliittyæ(ʔ)
liittää	Verb	ˈliːtːæː(ʔ)
liivate	Noun	ˈliːʋɑt̪e̞ˣ
lika	Noun	ˈlikɑ
likiarvo	Noun	ˈlikiˌɑrʋo
likinäköinen	Adjective	ˈlikiˌnækøinen
likinäköisyys	Noun	ˈlikiˌnækøisyːs
likka	Noun	ˈlɪʰkːa
liksa	Noun	ˈliksɑ
likööri	Noun	ˈlikøːri
lilja	Noun	ˈliljɑ
liljakukko	Noun	ˈliljɑˌkukːo
lima	Noun	ˈlaɪmə
limakko	Noun	ˈlimɑkːo
lime	Noun	laɪm
limerikki	Noun	ˈlimerikːi
limetti	Noun	ˈlimetːi
limppuun	Noun	ˈlimpːuːn
lingota	Verb	ˈliŋːotɑ(ʔ)
linjaauto	Noun	ˈlinjɑˌɑu̯to
linkki	Noun	ˈliŋkːi
linna	Noun	ˈlinːɑ
linnakundi	Noun	ˈlinːɑˌkundi
linnunrata	Noun	ˈlinːunˌrɑtɑ
lintsari	Noun	ˈlintsɑri
lintsata	Verb	ˈlintsɑtɑ(ʔ)
liottaa	Verb	ˈlio̞t̪ːɑːˣ
lipas	Noun	ˈlipɑs
lipevä	Adjective	ˈlipe̞ʋæ
lipeä	Noun	ˈlipe̞æ
lipeäkala	Noun	ˈlipe̞æˌkɑlɑ
liplatus	Noun	ˈliplɑtus
lippa	Noun	ˈlipːɑ
lippalakki	Noun	ˈlipːɑˌlɑkːi
lippu	Noun	ˈlipːu
lipuke	Noun	ˈlipuke
lista	Noun	ˈlistɑ
lisä	Noun	ˈlisæ
lisäaine	Noun	ˈlisæˌɑi̯neˣ
lisäkilpirauhanen	Noun	ˈlisæˌkilpiˌrɑuɦɑnen
lisäkives	Noun	ˈlisæˌkiʋes
lisämunuainen	Noun	ˈlisæˌmunuɑinen
lisää	Adverb	ˈlisæː
liti	Noun	ˈliti
litistää	Verb	ˈlit̪istæːˣ
litsi	Noun	ˈlitsi
litu	Noun	ˈlitu
liu'unta	Noun	ˈliu̯ˌuntɑ
liukua	Verb	ˈliukuɑˣ
liukumäki	Noun	ˈliukuˌmæki
liuotin	Noun	ˈliuɔtin
liuottaa	Verb	ˈliuɔt̪ːɑːˣ
liuta	Noun	ˈliutɑ
live	Verb	lɪv
livenä	Adjective	ˈliʋe̞næ
livistää	Verb	ˈliʋistæː(ʔ)
logaritmi	Noun	ˈlo̞ɡɑrit̪mi
lohkohedelmä	Noun	ˈloxkoˌhedelmæ
lohtu	Noun	ˈlohtu
loi	Verb	ˈloi̯
loihtia	Verb	ˈloi̯htiɑˣ
loikoa	Verb	ˈloi̯koɑˣ
loinen	Noun	ˈloinen
lois	Prefix	ˈlois
loisi	Verb	ˈlo̞isi
loistaapoissaolollaan	Verb	loistɑːˣ ˈpːoisːɑˌololːɑni
loiste	Noun	ˈloiste(ʔ)
loisteputki	Noun	ˈloisteˌpːutki
loitsu	Noun	ˈloitsu
lojaali	Adjective	ˈlojɑːli
lojune	Verb	ˈlo̞june̞ˣ
loki	Noun	ˈloki
lokikirja	Noun	ˈlokiˌkirjɑ
lokki	Noun	ˈlokːi
lomailla	Verb	ˈlomɑi̯lːɑˣ
lompakko	Noun	ˈlompɑkːo
lonkero	Noun	ˈloŋkero
lonkka	Noun	loŋkːɑ
lonkkamalja	Noun	ˈloŋkːɑˌmɑljɑ
loppiainen	Noun	ˈlopːiɑi̯nen
loputtomiin	Adverb	ˈloputːomiːn
lordi	Noun	lɔɻʈɪ
loru	Noun	ˈlo̞ru
lotta	Noun	ˈlotːɑ
louhikko	Noun	ˈlouɦikːo
loukata	Verb	ˈloukɑtɑ(ʔ)
loukkaantua	Verb	ˈloukːɑːntuɑ(ʔ)
lounainen	Adjective	ˈlounɑinen
lounas	Noun	ˈlo̞unɑs
lounasaika	Noun	ˈlou̯nɑsˌɑi̯kɑ
lude	Noun	luːdə
lue	Verb	ˈlue
luetella	Verb	ˈlue̞t̪e̞lːɑˣ
luettaa	Verb	ˈluetːɑːˣ
luettelo	Noun	ˈlue̞t̪ːe̞lo̞
luetuttaa	Verb	ˈluetutːɑː
luhistua	Verb	ˈluɦistuɑ(ʔ)
luhta	Noun	ˈluxtɑ
luhtalitukka	Noun	ˈluxtɑˌlitukːɑ
luiskahdella	Verb	ˈluiskaxˌde̞lːɑˣ
luistaa	Verb	ˈluistɑː(ʔ)
luistelija	Noun	ˈluiste̞lijɑ
luistella	Verb	ˈluistelːɑ(ʔ)
luistelu	Noun	ˈluistelu
luisua	Verb	ˈluisuɑˣ
lukea	Verb	ˈlukeɑˣ
lukema	Noun	ˈlukemɑ
lukija	Noun	ˈlukijɑ
lukio	Noun	ˈlukio̞
lukkari	Noun	ˈlukːɑri
lukko	Noun	ˈlukːo
luksus	Noun	ˈluksus
luku	Noun	ˈluku
lukumuisti	Noun	ˈlukuˌmuisti
lukutaidoton	Adjective	ˈlukuˌt̪ɑido̞t̪o̞n
lukutoukka	Noun	ˈlukuˌtoukːɑ
lumen	Noun	ˈluːmən
lumi	Noun	ˈlumi
lumikurki	Noun	ˈlumiˌkurki
lumipeite	Noun	ˈlumiˌpeite(ʔ)
lumivyöry	Noun	ˈlumiˌʋyøry
lumooja	Noun	ˈlumo̞ːjɑ
lunnasraha	Noun	ˈlunːɑsˌrɑɦɑ
luo	Noun	ˈluo(ʔ)
luoda	Verb	ˈluɔdɑ(ʔ)
luode	Noun	ˈluode(ʔ)
luodinreikä	Noun	ˈluodinˌreikæ
luokka	Noun	ˈluo̞kːɑ
luoko	Noun	ˈluo̯ko
luomi	Noun	ˈluomi
luomiväri	Noun	ˈluɔmiˌʋæri
luomu	Noun	ˈluomu
luomuviljely	Noun	ˈluomuˌʋiljely
luonne	Noun	ˈluo̞nːe̞
luonnehtia	Verb	ˈluɔnːehtiɑˣ
luonnollinen	Adjective	ˈluonːolːinen
luonnollinenhenkilö	Noun	ˈluonːolːinen ˈheŋkilø
luonnonsuojelija	Noun	ˈluonːonˌsuojelijɑ
luonnonsuojelualue	Noun	ˈluɔnːo̞nˌsuɔje̞luˌɑlue̞ˣ
luonnontieteidenkandidaatti	Noun	ˈluɔnːonˌtieteideŋ ˈkɑndiˌdɑːtːi
luonnos	Noun	ˈluo̞nːo̞s
luonnoton	Adjective	ˈluo̞nːo̞t̪o̞n
luonto	Noun	ˈluonto
luontokuvaaja	Noun	ˈluɔntoˌkuʋɑːjɑ
luopio	Noun	ˈluo̞pio̞
luostari	Noun	ˈluostɑri
luoteinen	Adjective	ˈluoteinen
luoti	Noun	ˈluoti
luotsi	Noun	ˈluɔtsi
luottaa	Verb	ˈluotːɑː(ʔ)
luottamusmies	Noun	ˈluɔt̪ːɑmusˌmies
luova	Adjective	ˈluɔʋɑ
luovuttaa	Verb	ˈluɔʋut̪ːɑːˣ
luovutus	Noun	ˈluɔʋutus
luovuus	Noun	ˈluɔʋuːs
lutka	Noun	ˈlutkɑ
luu	Verb	ˈluː
luuhauki	Noun	ˈluːˌhɑuki
luuli	Verb	ˈluːli
luulla	Verb	ˈluːlːɑ
luullen	Verb	luːlːen
luumarja	Noun	ˈluːˌmɑrjɑ
luumu	Noun	ˈluːmu
luuranko	Noun	ˈluːˌrɑŋko
luuri	Noun	ˈluːri
luuska	Noun	ˈluːskɑ
luuta	Noun	ˈluːt̪ɑ
luutaa	Noun	ˈluːtɑː
luutnantti	Noun	ˈluːt̪nan̪t̪ːi
luuton	Adjective	ˈluːt̪o̞n
luuttu	Noun	ˈluːt̪ːu
luvata	Verb	ˈluvɑtɑ
luvialainen	Noun	ˈluviɑlɑinen
lyhyt	Adjective	ˈlyhyt
lymfaattinen	Adjective	ˈlyɱfɑːt̪ːine̞n
lypsää	Verb	ˈlypsæːˣ
lyyra	Noun	ˈlyːrɑ
lyö	Verb	lyøː
lyödä	Verb	ˈlyødæ(ʔ)
lähde	Noun	ˈlæhde̞ˣ
lähdekoodi	Noun	ˈlæçde̞ˌkːo̞ːdi
lähdevesi	Noun	ˈlæcde̞ˌʋːe̞si
lähellä	Adverb	ˈlæɦe̞lːæ
lähestymiskielto	Noun	ˈlæhestymisˌkielto
lähestyä	Verb	ˈlæɦestyæ(ʔ)
lähetyspappi	Noun	ˈlæɦetysˌpɑpːi
lähi	Prefix	ˈlæɦi
lähin	Adjective	ˈlæɦin
lähinnä	Adverb	ˈlæɦinːæ
lähtekö	Verb	ˈlæhtekø(ʔ)
lähtemäisillään	Verb	ˈlæhtemæisilːæni
lähteä	Verb	ˈlæhteæˣ
lähtien	Verb	ˈlæçtien
lälläri	Noun	ˈlælːæri
lämpö	Noun	ˈlæmpø̞
lämpökamera	Noun	ˈlæmpø̞ˌkɑme̞rɑ
lämpöpaperi	Noun	ˈlæmpø̞ˌpɑpe̞ri
lämpötila	Noun	ˈlæmpø̞ˌt̪ilɑ
länget	Noun	ˈlæŋːet
länkkäri	Noun	ˈlæŋkˑkæˑri
lännenvaivaishiiri	Noun	ˈlænːenˌʋɑiʋɑisˌhiːri
läntti	Noun	ˈlæntːi
läpivalaisu	Noun	ˈlæpiˌʋɑlɑisu
läpivalaisuelektronimikroskooppi	Noun	ˈlæpiˌʋɑlɑisuˌelektroniˌmikroskoːpːi
läppä	Noun	ˈlæpːæ
läppäri	Noun	ˈlæpːæri
lätäkkö	Noun	ˈlætækːø
lävistää	Verb	ˈlæʋistæː(ʔ)
lääke	Noun	ˈlæːke̞ˣ
lääketiede	Noun	ˈlæːkeˌtːiede(ʔ)
lääkärintarkastus	Noun	ˈlæːkærinˌtɑrkɑstus
lääkäripelko	Noun	ˈlæːkæriˌpelko
lääni	Noun	ˈlæːni
läävä	Noun	ˈlæːʋæ
löisi	Verb	ˈlø̞isi
löperö	Adjective	ˈlø̞pe̞rø̞
löperösti	Adverb	ˈlø̞pe̞rø̞st̪i
löyly	Noun	ˈlø̞yly
löylykauha	Noun	ˈløy̯lyˌkɑu̯hɑ
löytymäisillään	Verb	ˈløyt̪ymæiˌsilːæni
löytö	Noun	ˈløyt̪ø
maailmanjärjestys	Noun	ˈmɑːilmɑnˌjærjestys
maailmankaikkeus	Noun	ˈmɑːilmɑnˌkɑikːeus
maailmankatsomuksellinen	Adjective	ˈmɑːilmɑŋkɑtsomukselːinen
maailmankuulu	Adjective	ˈmɑːilmɑnˌkuːlu
maailmanmusiikki	Noun	ˈmɑːilmɑnˌmusiːkːi
maailmansota	Noun	ˈmɑːilmɑnˌsotɑ
maakotka	Noun	ˈmɑːˌkotkɑ
maalari	Noun	ˈmɑːlɑri
maalarinteippi	Noun	ˈmɑːlɑrinˌteipːi
maalata	Verb	ˈmɑːlɑtɑ(ʔ)
maalattaessa	Verb	ˈmɑːlɑtːɑesːɑ
maalaus	Noun	ˈmɑːlɑu̯s
maalausteline	Noun	ˈmɑːlɑusˌt̪e̞line̞ˣ
maalauttaa	Verb	ˈmɑːlɑutːɑː(ʔ)
maali	Noun	ˈmɑːli
maalipotku	Noun	ˈmɑːliˌpo̞t̪ku
maaliviiva	Noun	ˈmɑːliˌʋiːʋɑ
maallinen	Adjective	ˈmɑːlːine̞n
maalämpö	Noun	ˈmɑːˌlæmpø̞
maametalli	Noun	ˈmɑːˌmetɑlːi
maanantai	Noun	ˈmɑːnɑn̪t̪ɑi
maanisäkäs	Noun	ˈmɑːˌnisækæs
maankaltainen	Adjective	ˈmɑːnˌkɑl.tɑi.nen
maankuulu	Adjective	ˈmɑːnˌkuːlu
maanosa	Noun	ˈmɑːnˌosɑ
maanpetos	Noun	ˈmɑːmˌpetos
maanpuolustus	Noun	ˈmɑːnˌpuolustus
maantaa	Verb	ˈmɑːntɑː
maantie	Noun	ˈmɑːnˌtie(ʔ)
maantiejuna	Noun	ˈmɑːnˌtieˌjunɑ
maapallo	Noun	ˈmɑːˌpɑlːo
maaseutu	Noun	ˈmɑːˌseutu
maastoauto	Noun	ˈmɑːstoˌɑuto
maastohiihto	Noun	ˈmɑːstoˌç̞iːç̞to
maastopyörä	Noun	ˈmɑːstoˌpyøræ
maata	Noun	ˈmɑːtɑ
maatalous	Noun	ˈmɑːˌtɑlous
maattaa	Verb	ˈmɑːtːɑːˣ
maatua	Verb	ˈmɑːt̪uɑˣ
maavarsi	Noun	ˈmɑːˌʋɑrsi
macaron	Noun	mækəˈɹɒn
machomies	Noun	ˈmɑkho̞ˌmie̞s
made	Noun	meɪ̯d
madeleine	Noun	ˈmadəleɪn
magmakivilaji	Noun	ˈmɑɡmɑˌkiʋiˌlɑji
magneetittomuus	Noun	ˈmaŋneːtiˌtːomuːs
magneetti	Noun	ˈmɑŋneːtːi
magneettikenttä	Noun	ˈmɑŋne̞ːt̪ːiˌke̞n̪t̪t̪æ
maha	Noun	ˈmɑhɑ
maharadža	Noun	ˈmɑhɑˌrɑdʒɑ
mahdollinen	Adjective	ˈmɑxdo̞lːine̞n
mahdollisesti	Adverb	ˈmɑhdolːiˌsesti
mahla	Noun	ˈmɑhlɑ
mahorkka	Noun	ˈmɑɦo̞rkːɑ
mahtaa	Verb	ˈmɑxt̪ɑːˣ
mahti	Noun	ˈmɑhti
mahtua	Verb	ˈmɑɦtuɑ(ʔ)
maihari	Noun	ˈmɑiɦɑri
maihinnousu	Noun	ˈmɑiɦinˌnousu
maihinnousuportti	Noun	ˈmɑiɦiˌnːousuˌportːi
maija	Noun	ˈmɑijɑ
maikka	Noun	ˈmɑikːɑ
mainari	Noun	ˈmɑinɑri
maine	Noun	ˈmɑi̯ne
maininta	Noun	ˈmɑinintɑ
mainittako	Verb	ˈmɑinitːɑko(ʔ)
mainittakoon	Verb	ˈmɑinitːɑkoːn
mainos	Noun	ˈmɑino̞s
mainostaa	Verb	ˈmɑinostɑː(ʔ)
maisema	Noun	ˈmɑisemɑ
maissi	Noun	ˈmɑisːi
maistaa	Verb	ˈmɑi̯stɑːˣ
maistaaomaalääkettään	Phrase	ˈmɑistɑːʔʔˈomɑːˈlæːketːæːn
maisteri	Noun	ˈmɑisteri
maistraatti	Noun	ˈmɑistrɑːtːi
maitorahka	Noun	ˈmɑitoˌrɑxkɑ
maitotuote	Noun	ˈmɑitoˌtuote(ʔ)
maitse	Adverb	ˈmɑi̯tseˣ
maja	Noun	ˈmaja
majaa	Noun	ˈmɑjɑː
majakka	Noun	ˈmɑjɑkːɑ
majuri	Noun	ˈmɑjuri
makaroni	Noun	ˈmɑkɑro̞ni
makeinen	Noun	ˈmɑkeinen
makeutusaine	Noun	ˈmɑke̞ut̪usˌɑine̞ˣ
makkara	Noun	ˈmɑkːɑrɑ
maksa	Noun	ˈmɑksɑ
maksaa	Noun	ˈmɑksɑː
maksaläiskä	Noun	ˈmɑksɑˌlæiskæ
maksamasta	Verb	ˈmɑksɑmɑstɑ
maksasammal	Noun	ˈmɑksɑˌsɑmːɑl
maku	Noun	ˈmɑku
makuaisti	Noun	ˈmɑkuˌɑisti
malja	Noun	ˈmɑljɑ
maljapuhe	Noun	ˈmɑljɑˌpuɦeˣ
malli	Noun	ˈmɑlːi
malline	Noun	ˈmɑlːineˣ
malmi	Noun	ˈmɑlmi
malta	Noun	ˈmɑltɑ
maltalainen	Adjective	ˈmɑltɑˌlɑinen
maltillisuus	Noun	ˈmɑltilːisuːs
malto	Noun	ˈmɑlto
maltoosi	Noun	ˈmɑltoːsi
maltti	Noun	ˈmɑltːi
mamelukki	Noun	ˈmɑmelukːi
mammanpoika	Noun	ˈmɑmːɑnˌpoikɑ
mammografia	Noun	ˈmɑmːoˌɡrɑfiɑ
mammona	Noun	ˈmɑmːonɑ
manageri	Noun	ˈmɑnɑɡeri
manala	Noun	ˈmɑnɑlɑ
manata	Verb	ˈmɑnɑt̪ɑ(ʔ)
mandoliini	Noun	ˈmɑndoliːni
maneeri	Noun	ˈmɑneːri
mangrove	Noun	ˈmæŋɡɹəʊv
manifestaatio	Noun	ˈmɑnifesˌtɑːtio
manikyyri	Noun	ˈmɑnikyːri
manipuloida	Verb	ˈmɑnipuloidɑ(ʔ)
mankka	Noun	ˈmɑŋkːɑ
manner	Noun	ˈmænə
mannerlaatta	Noun	ˈmɑnːerˌlɑːtːɑ
manometri	Noun	ˈmɑnoˌmetri
mansikka	Noun	ˈmɑnsikːɑ
mansikkahillo	Noun	ˈmɑnsikːɑˌç̞ilːo
mansikkainen	Adjective	ˈmɑnsikːˌɑinen
manteli	Noun	ˈmɑnteli
manto	Noun	ˈmɑnto
manumissio	Noun	ˈmɑnuˌmisːio
manööveri	Noun	ˈmɑnøːʋeri
marathi	Noun	ˈmɑrɑthi
marenki	Noun	ˈmɑreŋki
mari	Adjective	ˈmɑri
marina	Noun	məˈɹinə
marinadi	Noun	ˈmɑrinɑdi
marja	Noun	ˈmɑrjɑ
marjapussi	Noun	ˈmɑrjɑˌpusːi
marjoa	Verb	ˈmɑrjoɑˣ
markiisi	Noun	ˈmɑrkiːsi
markiisitar	Noun	ˈmɑrkiːsitɑr
markkinoida	Verb	ˈmɑrkːinoidɑ(ʔ)
marmeladi	Noun	ˈmɑrmelɑdi
marmori	Noun	ˈmɑrmori
marokkolainen	Adjective	ˈmɑrokːoˌlɑinen
marosi	Noun	ˈmɑro̞si
marras	Noun	ˈmɑrːɑs
marraskesi	Noun	ˈmɑrːɑsˌkesi
marraskuu	Noun	ˈmɑrːɑsˌkuː
marsalkka	Noun	ˈmɑrsɑlkːɑ
marshrutka	Noun	ˈmɑrsˑrut̪ˑkɑ
marsilainen	Adjective	ˈmɑrsiˌlɑinen
marsipaani	Noun	ˈmɑrsipɑːni
marssi	Noun	ˈmɑrsːi
marssia	Noun	ˈmɑrsːi.ɑˣ
martta	Noun	ˈmɑrtːɑ
masennus	Noun	ˈmɑse̞nːus
masennuslääke	Noun	ˈmɑsenːusˌlæːke(ʔ)
masiina	Noun	ˈmɑsiːnɑ
masinointi	Noun	ˈmɑsinointi
maskara	Noun	ˈmɑskɑrɑ
maskotti	Noun	ˈmɑskotːi
maskuliini	Adjective	ˈmɑskuˌliːni
masokismi	Noun	ˈmɑsokismi
masokisti	Noun	ˈmɑsokisti
masokistinen	Adjective	ˈmɑsokisˌtinen
massatuotanto	Noun	ˈmɑsːɑˌtuotɑnto
massiivi	Noun	ˈmɑsːiːʋi
massiivinen	Adjective	ˈmɑsːiːˌʋinen
mastiffi	Noun	ˈmɑstifːi
mastodontti	Noun	ˈmɑstodontːi
masturbaatio	Noun	ˈmɑsturˌbɑːtio
masu	Noun	ˈmasuː
matadori	Noun	ˈmɑtɑdori
matelija	Noun	ˈmɑtelijɑ
matematiikka	Noun	ˈmɑt̪e̞mɑt̪iːkːɑ
materialisti	Noun	ˈmɑteriɑˌlisti
materialistinen	Adjective	ˈmɑteriɑˌlistinen
matkailija	Noun	ˈmɑtkɑiˌlija
matkailu	Noun	ˈmɑtkɑilu
matkapuhelin	Noun	ˈmɑtkɑˌpuhelin
matkata	Verb	ˈmɑtkɑtɑ(ʔ)
mato	Verb	ˈmato
matriisi	Noun	ˈmɑtriːsi
matsi	Noun	ˈmɑt̪si
matti	Noun	ˈmɑtːi
maukas	Noun	ˈmɑukɑs
maustaa	Verb	ˈmɑustɑː
mauste	Noun	ˈmɑuste̞ˣ
mausteneilikka	Noun	ˈmɑuste̞ˌnːe̞ilikːɑ
maustepippuri	Noun	ˈmɑuste̞ˌpːipːuri
mauton	Adjective	ˈmɑut̪o̞n
me	Pronoun	miː
meetvursti	Noun	ˈmeːtʋursti
mehiläinen	Noun	ˈmehilæinen
mehiläisvaha	Noun	ˈme̞ɦilæisˌʋɑɦɑ
meidän	Pronoun	ˈmeidæn
meihin	Pronoun	ˈmeihin
meikkaaja	Noun	ˈmeikːɑːjɑ
meikki	Noun	ˈme̞ikːi
meikkivoide	Noun	ˈme̞ikːiˌʋo̞ide̞ˣ
meiksi	Pronoun	ˈmeiksi
meille	Pronoun	ˈmeilːe(ʔ)
meiltä	Pronoun	ˈmeiltæ
meinata	Verb	ˈmeinɑtɑ(ʔ)
meinä	Pronoun	ˈmeinæ
meirami	Noun	ˈmeirɑmi
meissä	Pronoun	ˈmeisːɑ
meistä	Pronoun	ˈmeistæ
meitsi	Pronoun	ˈmeitsi
meittä	Pronoun	ˈmeitːæ
meitä	Pronoun	ˈmeitæ
mekaniikka	Noun	ˈme̞kɑniːkːɑ
meksikolainen	Noun	ˈmeksikolɑi̯nen
mela	Noun	mela
melkoinen	Adjective	ˈmelkoinen
mellakkapoliisi	Noun	ˈme̞lːɑkːɑˌpo̞liːsi
mellakoija	Noun	ˈmelːɑkoijɑ
mellastus	Noun	ˈmelːɑstus
meloa	Verb	ˈmeloɑˣ
melodinen	Adjective	ˈmelodinen
meloja	Noun	ˈme̞lo̞jɑ
meloni	Noun	ˈmeloni
menetellä	Verb	ˈmenetelːæ(ʔ)
menettää	Verb	ˈmenetːæ(ʔ)
menkat	Noun	ˈmeŋkɑt
mennessä	Verb	ˈmenːesːæ
mennä	Verb	ˈmenːæˣ
mennänaimisiin	Verb	ˈme̞nːæˈnːɑimisiːn
menot	Noun	ˈme̞no̞t
menu	Noun	ˈmɛnjuː
merenneito	Noun	ˈmereˌnːeito
merenpinta	Noun	ˈmerenˌpintɑ
meri	Noun	ˈmeri
meribiologia	Noun	ˈme̞riˌbio̞lo̞ɡiɑ
merilevä	Noun	ˈme̞riˈleʋæ
meripeninkulma	Noun	ˈmeriˌpeninˌkulmɑ
merisavu	Noun	ˈmeriˌsɑʋu
meriskorpioni	Noun	ˈmeriˌskorpioni
merivesi	Noun	ˈmeriˌʋesi
merkityksetön	Adjective	ˈmerkityksetøn
merkitä	Verb	ˈmerkitæ(ʔ)
merkki	Noun	ˈme̞rk̟ːi
merkkijono	Noun	ˈmerkːiˌjono
merta	Noun	ˈmertɑ
mesenaatti	Noun	ˈmeseˌnɑːtːi
mesi	Noun	ˈme̞si
mesimäyrä	Noun	ˈme̞siˌmæyræ
messi	Noun	ˈmesːi
mestari	Noun	ˈme̞stɑri
met	Verb	mɛt
metaani	Noun	ˈmetɑːni
metalli	Noun	ˈmet̪ɑlːi
metallisaha	Noun	ˈmetɑlːiˌsɑɦɑ
metelöidä	Verb	ˈmetelœ̞idæˣ
metelöinti	Noun	ˈmetelœinti
meteori	Noun	ˈmeteori
meteoriitti	Noun	ˈmeteoriːtːi
meteoroidi	Noun	ˈmeteoroidi
metrijärjestelmä	Noun	ˈmetriˌjærjestelmæ
metso	Noun	ˈmetso
metsokukko	Noun	ˈme̞t̪so̞ˌkukːo̞
metsäkaarti	Noun	ˈmetsæˌkɑːrti
metsäkaartilainen	Noun	ˈmetsæˌkɑːrtilɑinen
metsäkorte	Noun	ˈmetsæˌkorte(ʔ)
metsäkurjenpolvi	Noun	ˈmetsæˌkurjemˌpolʋi
metsäsopuli	Noun	ˈmetsæˌsopuli
metvursti	Noun	ˈmeːtʋursti
meänkieli	Noun	ˈme̞.æŋkie̞li
miau	Interjection	ˈmiɑu
miehittäjä	Noun	ˈmiehitːæjæ
miehittämätön	Noun	ˈmieɦitːæˌmætøn
miehittää	Verb	ˈmieɦitːæː(ʔ)
miehitys	Noun	ˈmieɦit̪ys
miehuullinen	Adjective	ˈmiehuːlːinen
miekka	Noun	ˈmiekːɑ
miekkailla	Verb	ˈmiekːɑilːɑ(ʔ)
miekkalilja	Noun	ˈmiekːɑˌliljɑ
mieleen	Noun	ˈmie̞le̞ːn
mielellään	Adverb	ˈmielelːæːn
mielenfilosofia	Noun	ˈmielenˌfilosofiɑ
mielenhäiriö	Noun	ˈmielenˌhæiriø
mielenilmaisu	Noun	ˈmielenˌilmɑisu
mielenilmaus	Noun	ˈmielenˌilmɑisu
mielenterveydellinen	Adjective	ˈmielenˌterʋeyˌdelːinen
mielenterveys	Noun	ˈmielenˌterʋeys
mielentilatutkimus	Noun	ˈmielenˌtilɑˌtutkimus
mielettä	Noun	ˈmieletːæ
mieletön	Adjective	ˈmieletøn
mieli	Noun	ˈmieli
mieliin	Noun	ˈmieliːn
mielijohde	Noun	ˈmieliˌjoxde
mielikuvakartta	Noun	ˈmieliˌkuʋɑˌkɑrtːɑ
mielikuvitusleikki	Noun	ˈmieliˌkuʋitusˌleikːi
mielikuvitusystävä	Noun	ˈmieliˌkuʋitusˌystæʋæ
mielipideero	Noun	ˈmielipideʔːˌero
mielipidekirjoitus	Noun	ˈmieliˌpideˌkirjoitus
mielissään	Adverb	ˈmielisːæːn
mielistely	Noun	ˈmielistely
mielle	Noun	ˈmie̞lːe̞ˣ
miellekartta	Noun	ˈmielːeˌkːɑrtːɑ
mies	Noun	ˈmie̯s
mieskunto	Noun	ˈmie̞sˌkun̪t̪o̞
mieskuoro	Noun	ˈmie̞sˌkuɔro̞
miesleski	Noun	ˈmiesˌleski
miesopettaja	Noun	ˈmie̞sˌo̞pe̞t̪ːɑjɑ
miespuolinen	Adjective	ˈmie̞sˌpuɔline̞n
miessukupuoli	Noun	ˈmie̞sˌsukuˌpuɔli
miestappo	Noun	ˈmiesˌtɑpːo
miesystävä	Noun	ˈmie̞sˌystæʋæ
miesääni	Noun	ˈmie̞sˌæːni
mieto	Adjective	ˈmie̞t̪o̞
miettiä	Verb	ˈmie̞t̪ːi.æˣ
migreeni	Noun	ˈmiɡreːni
migreenikohtaus	Noun	ˈmiɡreːniˌkoxtɑus
miilu	Noun	ˈmiːlu
miina	Noun	ˈmiːnɑ
miinusmerkki	Noun	ˈmiːnusˌmerkːi
miitinki	Noun	ˈmiːtiŋki
mikkeli	Noun	ˈmikːeli
mikkelinpäivä	Noun	ˈmikːelinˌpæi̯ʋæ
mikroaalto	Noun	ˈmikro̞ˌɑːlto̞
mikroaaltouuni	Noun	ˈmikro̞ˌɑːlto̞ˌuːni
mikrobiekologia	Noun	ˈmikrobiˌekoloɡiɑ
mikrosekunti	Noun	ˈmikrosekunti
mikrotukihenkilö	Noun	ˈmikroˌtukiˌheŋkilø
miksaus	Noun	ˈmiksɑus
miksotrofia	Noun	ˈmiksotrofiɑ
militarisoida	Verb	ˈmilitɑriˌsoidɑ(ʔ)
militarisoitua	Verb	ˈmilitɑrisoituɑ(ʔ)
miljoonakala	Noun	ˈmiljoːnɑˌkɑlɑ
miljoonakaupunki	Noun	ˈmiljoːnɑˌkɑupuŋki
miljoonakutoja	Noun	ˈmiljoːnɑˌkutojɑ
miljoonapalo	Noun	ˈmiljoːnɑˌpɑlo
miljoonasosa	Noun	ˈmiljoːnɑsˌosɑ
miljoonikko	Noun	ˈmiljoːˌnikːo
millainen	Adjective	ˈmilːɑinen
milletinpäästäinen	Noun	ˈmilːetimˌpæːstæinen
milliampeeri	Noun	ˈmilːiˌɑmpeːri
millikaarisekunti	Noun	ˈmilːiˌkɑːrisekunti
millisekunti	Noun	ˈmilːisekunti
milloinka	Adverb	ˈmilːoiŋkɑ
mimoosamainen	Adjective	ˈmimoːsɑˌmɑinen
minariini	Noun	ˈminɑriːni
mindanaonrotta	Noun	ˈmindɑnɑonˌrotːɑ
mindanaonrottasiili	Noun	ˈmindɑnɑonˌrotːɑˌsiːli
mineraaliesiintymä	Noun	ˈminerɑːliˌesiːntymæ
mineraalikuitu	Noun	ˈminerɑːliˌkuitu
mineraalinen	Adjective	ˈminerɑːliˌnen
mineraalipitoinen	Adjective	ˈminerɑːliˌpitoinen
mineraalisuola	Noun	ˈminerɑːliˌsuɔlɑ
mineraalivilla	Noun	ˈminerɑːliˌʋilːɑ
minestronekeitto	Noun	ˈminestroneˌkeitːo
miniatyyrikoko	Noun	ˈminiɑtyːriˌkoko
miniatyyrikokoinen	Adjective	ˈminiɑtyːriˌkokoinen
minimaalisesti	Adverb	ˈminimɑːliˌsesti
ministeri	Noun	ˈministeri
miniä	Noun	ˈminiæ
minkki	Noun	ˈmiŋkːi
minkälainen	Adjective	ˈmiŋkæˌlɑinen
minolainen	Adjective	ˈminoˌlɑinen
minttu	Noun	ˈmintːu
minttusuklaa	Noun	ˈmintːuˌsuklɑː
minttutee	Noun	ˈmintːuˌteː
minua	Pronoun	ˈminuɑ
minuksi	Pronoun	ˈminuksi
minulla	Pronoun	ˈminulːɑ
minulle	Pronoun	ˈminulːe(ʔ)
minulta	Pronoun	ˈminultɑ
minuna	Pronoun	ˈminunɑ
minussa	Pronoun	ˈminusːɑ
minusta	Pronoun	ˈminustɑ
minut	Adjective	miˈnut
minutta	Pronoun	ˈminutːɑ
minuun	Pronoun	ˈminuːn
minuutti	Noun	ˈminuːtːi
minä	Pronoun	ˈminæ
miraakkeli	Noun	ˈmirɑːkːeli
mirhami	Noun	ˈmirɦɑmi
mirri	Noun	ˈmirːi
misogyyninen	Adjective	ˈmisoɡyːninen
mispeli	Noun	ˈmispeli
missi	Noun	ˈmisːi
missä	Pronoun	ˈmisːæ
misu	Noun	ˈmisu
mitata	Verb	ˈmitɑtɑˣ
mittaaja	Noun	ˈmitːɑːjɑ
mittaamaton	Adjective	ˈmitːɑːmɑton
mittaaminen	Noun	ˈmitːɑːˌminen
mittari	Noun	ˈmitːɑri
mittelö	Noun	ˈmitːelø
mitätöidä	Verb	ˈmitætøidæ
mitätöinti	Noun	ˈmitætøinti
moaree	Noun	ˈmo̞ɑre̞ː
moat	Noun	məʊt
mobilisoida	Verb	ˈmobilisoidɑ(ʔ)
modeemi	Noun	ˈmodeːmi
modernisoida	Verb	ˈmodernisoidɑ(ʔ)
modernisoitua	Verb	ˈmodernisoituɑ(ʔ)
moduloida	Verb	ˈmoduloidɑ(ʔ)
moduuli	Noun	ˈmoduːli
moi	Interjection	ˈmoi̯
moikata	Verb	ˈmoikɑtɑˣ
moikua	Verb	ˈmo̞iku.ɑˣ
moiré	Noun	mwaˈɹeɪ
moittia	Verb	ˈmo̞itːi.ɑˣ
moku	Verb	ˈmoku
molekyyli	Noun	ˈmolekyːli
molli	Noun	ˈmoː.lːi
moninkertaistaa	Verb	ˈmoniŋkertɑistɑː(ʔ)
moninkertaistua	Verb	ˈmoniŋkertɑistuɑ
monistaa	Verb	ˈmonistɑː(ʔ)
monistua	Verb	ˈmonistuɑ(ʔ)
monitori	Noun	ˈmonit̪ori
monopoli	Noun	ˈmonopoli
monopolisoida	Verb	ˈmonopolisoidɑ(ʔ)
moon	Noun	muːn
moonbootsit	Noun	ˈmuːnˌbuːtsit
moppi	Noun	ˈmo̞pːi
mopsi	Noun	ˈmopsi
moraali	Noun	ˈmorɑːli
moralisoida	Verb	ˈmorɑlisoidɑ(ʔ)
morsio	Noun	ˈmorsio
motivoida	Verb	ˈmotivoidɑ(ʔ)
motivoitua	Verb	ˈmotiʋoi̯tuɑˣ
motoristi	Noun	ˈmotoristi
moukari	Noun	ˈmoukɑri
movettaa	Verb	ˈmovetːɑː(ʔ)
muhkura	Noun	ˈmuxʷkurɑ
muiden	Noun	ˈmœy̯.də(n)
muija	Noun	ˈmuijːɑ
muikku	Noun	ˈmuikːu
muinainen	Adjective	ˈmuinɑine̞n
muinaiskieli	Noun	ˈmuinɑisˌkieli
muistaa	Verb	ˈmui̯stɑːˣ
muistiaukko	Noun	ˈmuistiˌɑukːo
muistoisa	Adjective	ˈmuistoisɑ
muka	Noun	ˈmukɑ
mukaan	Adverb	ˈmukɑːn
mukaelma	Noun	ˈmukɑelmɑ
mukautumiskyky	Noun	ˈmukɑutumisˌkyky
mukavuuslippu	Noun	ˈmukɑʋuːsˌlipːu
mukavuuslippulaiva	Noun	ˈmukɑʋuːsˌlipːuˌlɑiʋɑ
muki	Noun	ˈmuki
mukula	Noun	ˈmukulɑ
mukulaartisokka	Noun	ˈmukulɑ(ʔ)ˌɑrtisokːɑ
mulli	Noun	ˈmulːi
munakas	Noun	ˈmunɑkɑs
munakello	Noun	ˈmunɑˌke̞lːo̞
munakotelo	Noun	ˈmunɑˌkotelo
munia	Noun	ˈmuni.ɑ
munii	Verb	ˈmuniː
munkki	Noun	ˈmuŋkːi
munkkius	Noun	ˈmuŋkːius
muokata	Verb	ˈmuokɑtɑ
muonittaa	Verb	ˈmuɔnitːɑːˣ
muonitus	Noun	ˈmuɔnitus
muoti	Noun	ˈmuoti
muotoilija	Noun	ˈmuɔtoilijɑ
muotoilla	Verb	ˈmuɔtoilːɑ(ʔ)
muotoilu	Noun	ˈmuɔtoilu
muovi	Noun	ˈmuoʋi
mureena	Noun	ˈmureːnɑ
murha	Noun	ˈmurhɑ
murhaaja	Noun	ˈmurhɑːjɑ
murhata	Verb	ˈmurhɑtɑ(ʔ)
murju	Noun	ˈmurju
murkku	Noun	ˈmurkːu
murska	Noun	ˈmurskɑ
murskaaja	Noun	ˈmurskɑːjɑ
muru	Noun	ˈmuru
murut	Noun	ˈmurut̪
musa	Noun	ˈmu.zə
musiikki	Noun	ˈmusiːkːi
musketti	Noun	ˈmuske̞t̪ːi
muskettimies	Noun	ˈmuske̞t̪ːiˌmie̞s
muskotti	Noun	ˈmuskotːi
musta	Interjection	ˈmustɑ
mustaherukka	Noun	ˈmustɑˌherukːɑ
mustajoulu	Noun	ˈmustɑ jou̯lu
mustajää	Noun	ˈmustɑ jæː
mustalainen	Noun	ˈmustɑˌlɑinen
mustalista	Noun	ˈmustɑ ˈlistɑ
mustamuurahainen	Noun	ˈmustɑˌmuːrɑˌɦɑinen
mustapippuri	Noun	ˈmustɑˌpipːuri
mustatokko	Noun	ˈmustɑˌtokːo
mustaviinimarja	Noun	ˈmustɑˌʋiːniˌmɑrjɑ
mutageeni	Noun	ˈmutɑɡeːni
mutatismutandis	Adverb	m(j)uːˌtɑːtɪs muːˈtandɪs
mutka	Noun	ˈmutkɑ
mutsi	Noun	ˈmutsi
mutu	Adjective	ˈmu.tu
muu	Noun	ˈmuː
muuli	Noun	ˈmuːli
muulla	Pronoun	ˈmuːlːɑ
muumio	Noun	ˈmuːmio̞
muurin	Noun	ˈmuːrin
muusikko	Noun	ˈmuːsikːo̞
muuta	Pronoun	ˈmuːtɑ
muutama	Pronoun	ˈmuːt̪ɑmɑ
muuttaa	Verb	ˈmuːtːɑːˣ
muuttuja	Noun	ˈmuːt̪ːujɑ
mykerö	Noun	ˈmykerø
myllerrys	Noun	ˈmylːerːys
myrkkykoiso	Noun	ˈmyrkːyˌkoiso
myrsky	Noun	myrsky
mystikon	Noun	ˈmystikon
myy	Noun	ˈmyː
myydä	Verb	ˈmyːdæˣ
myyräkuume	Noun	ˈmyːræˌkuːme(ʔ)
myötävaikuttaminen	Noun	ˈmyøtæˌʋɑikuˌtːɑminen
myötävaikutus	Noun	ˈmyøtæˌʋɑikutus
mädättää	Verb	ˈmædætːæː(ʔ)
mäikyä	Verb	ˈmæiky.æˣ
mäki	Noun	ˈmæki
mäkärä	Noun	ˈmækæræ
mäkäräinen	Noun	ˈmækæræinen
mämmi	Noun	ˈmæmːi
mänty	Noun	ˈmænty
märehtijä	Noun	ˈmærehtijæ
märkiä	Adjective	ˈmærki.æ
mäti	Noun	ˈmæt̪i
mätiä	Adjective	ˈmæt̪i.æ
mätäkuu	Noun	ˈmætæˌkuː
mätäs	Noun	ˈmætæs
määi	Verb	ˈmæː.iˣ
määkiä	Verb	ˈmæːki.æˣ
määkyä	Verb	ˈmæːky.æˣ
määre	Noun	ˈmæːre̞ˣ
määritellä	Verb	ˈmæːritelːæ(ʔ)
määrittää	Verb	ˈmæːritːæː(ʔ)
määrä	Noun	ˈmæːræ
määränpää	Noun	ˈmæːræmˌpæː
määrätä	Verb	ˈmæːrætæ(ʔ)
määräys	Noun	ˈmæːræys
määy	Verb	ˈmæː.yˣ
möhläys	Noun	ˈmøçlæys
mökki	Noun	ˈmø̞kːi
möly	Noun	ˈmøly
mölyapina	Noun	ˈmølyˌɑpinɑ
mönkijä	Noun	ˈmø̞ŋkijæ
mönkiä	Verb	ˈmø̞ŋki.æˣ
mörkö	Noun	ˈmørkø
nikotiini	Noun	ˈniko̞t̪iːni
niksi	Noun	ˈniksi
nilkka	Noun	ˈnilkːɑ
nilkki	Noun	ˈnilkːi
nimenomaan	Adverb	ˈnimenˌomɑːn
nimenselvennys	Noun	ˈnimenˌselʋenːys
nimetä	Verb	ˈnimetæˣ
nimetön	Adjective	ˈnime̞t̪ø̞n
nimiavaruus	Noun	ˈnimiˌɑʋɑruːs
nimitellä	Verb	ˈnimit̪e̞lːæˣ
nimittää	Verb	ˈnimitːæː(ʔ)
nipistää	Verb	ˈnipistæːˣ
nippu	Noun	ˈnipːu
nippuside	Noun	ˈnipːuˌside̞ˣ
nirkko	Noun	ˈnirkːo
niska	Noun	ˈniskɑ
niskalenkkitoppi	Noun	ˈniskɑˌleŋkːiˌtopːi
nisä	Noun	ˈnisæ
nitistää	Verb	ˈnitistæː(ʔ)
nitraatti	Noun	ˈnit̪rɑːt̪ːi
nitrifikaatio	Noun	ˈnit̪rifiˌkɑːt̪io̞
nitriitti	Noun	ˈnit̪riːt̪ːi
nobo	Noun	ˈno̞bo̞
noen	Noun	nun
noet	Noun	ˈno̞e̯t̪
noi	Pronoun	ˈnoi̯
noiden	Pronoun	ˈnoiden
noin	Adverb	ˈno̞in
noita	Noun	ˈnoit̪ɑ
noitasapatti	Noun	ˈnoitɑˌsɑpɑtːi
noitten	Pronoun	ˈnoitːen
noitua	Verb	ˈnoituɑ(ʔ)
noja	Noun	ˈnojɑ
nojatuoli	Noun	ˈnojɑˌtuoli
noki	Noun	ˈno̞ki
nokkaeläin	Noun	ˈnokːɑˌelæin
nokkahuilu	Noun	ˈnokːɑˌhuilu
nokkakolari	Noun	ˈnokːɑˌkolɑri
nokkava	Adjective	ˈnokːɑʋɑ
nokkavarpunen	Noun	ˈnokːɑˌʋɑrpunen
nokki	Verb	ˈnokːi
nokkia	Noun	ˈno̞kːi.ɑ
nokkonen	Noun	ˈnokːonen
nokkosihottuma	Noun	ˈnokːosˌihotːumɑ
nokkoskasvi	Noun	ˈnokːosˌkɑsʋi
nokkoskeitto	Noun	ˈnokːosˌkeitːo
nokkosperhonen	Noun	ˈnokːosˌperhonen
nokkosrokko	Noun	ˈnokːosˌrokːo
nollakohta	Noun	ˈnolːɑˌkoxtɑ
nollakoko	Noun	ˈnolːɑˌkoko
nollata	Verb	ˈnolːɑtɑ(ʔ)
nolo	Adjective	ˈnolo
nopeus	Noun	ˈnopeu̯s
noppa	Noun	ˈno̞pːɑ
nordisti	Noun	ˈnordisti
norjalainen	Noun	ˈnorjɑˌlɑinen
norkko	Noun	ˈnorkːo
normaaliaika	Noun	ˈnormɑːliˌɑi̯kɑ
norri	Noun	ˈnorːi
norsupäästäinen	Noun	ˈnorsuˌpæːstæinen
noskapiini	Noun	ˈnoskɑpiːni
nostatusaine	Noun	ˈno̞stɑt̪usˌɑine̞ˣ
noste	Noun	ˈno̞ste̞ˣ
notkea	Adjective	ˈnotkeɑ
notkeagibboni	Noun	ˈnotkeɑˌɡibːoni
notski	Noun	ˈnotski
nougat	Noun	ˈnuːɡɑː
noukkia	Verb	ˈnoukːi.ɑˣ
nousta	Verb	ˈnoustɑ(ʔ)
noutaja	Noun	ˈnoutɑjɑ
novascotiannoutaja	Noun	ˈnoʋɑˌskotiɑnˌnoutɑjɑ
novelli	Noun	ˈnoʋelːi
nubianvilliaasi	Noun	ˈnuːbiɑnˌʋilːiˌɑːsi
nudismi	Noun	ˈnudismi
nudisti	Noun	ˈnudisti
nugaa	Noun	ˈnuɡɑː
nuha	Noun	ˈnuɦɑ
nuhde	Noun	ˈnuxde̞ˣ
nuhteeton	Noun	ˈnuxt̪e̞ːt̪o̞n
nukahtaa	Verb	ˈnukɑhtɑː(ʔ)
nukka	Noun	ˈnukːɑ
nukkasihti	Noun	ˈnukːɑˌsihti
nukkehallitus	Noun	ˈnukːe̞ˌxɑlːit̪us
nukkua	Verb	ˈnukːuɑˣ
nukkuja	Noun	ˈnukːujɑ
nukkumaanmenoaika	Noun	ˈnukːumɑːnˌme̞no̞ˌɑikɑ
nuku	Verb	ˈnukuˣ
nummi	Noun	ˈnumːi
nuo	Verb	ˈnuo
nuode	Noun	ˈnuɔde
nuokkua	Verb	ˈnuo̞kːuɑ
nuolenpääkirjoitus	Noun	ˈnuolenˌpæːˌkirjoitus
nuoli	Noun	ˈnuoli
nuolihaukka	Noun	ˈn̪uo̞liˌhɑukːɑ
nuolimyrkkysammakko	Noun	ˈnuɔliˌmyrkːyˌsɑmːɑkːo
nuolla	Verb	ˈnuɔlːɑˣ
nuollen	Verb	nuolːen
nuotanveto	Noun	ˈnuɔtɑnˌʋeto
nuotisto	Noun	ˈnuɔtiˌsto
nurkua	Verb	ˈnurku.ɑˣ
nurmi	Noun	ˈnurmi
nurmilaukka	Noun	ˈnurmiˌlɑukːɑ
nurmipora	Noun	ˈnurmiˌporɑ
nussia	Verb	ˈnusːi.ɑˣ
nuta	Noun	ˈnutɑ
nutriaturkki	Noun	ˈnutriɑˌturkːi
nuuska	Noun	ˈnuːskɑ
nyhälaitainen	Adjective	ˈnyɦæˌlɑitɑinen
nyit	Verb	ˈnyit̪
nykiä	Verb	ˈnyki.æˣ
nykyaika	Noun	ˈnykyˌɑi̯kɑ
nymfi	Noun	ˈn̪yɱfi
nyppiä	Verb	ˈnypːi.æˣ
nyrkkeillä	Verb	ˈnyrkːe̞ilːæˣ
nyrkki	Noun	ˈnyrkːi
nysse	Noun	ˈnysːe
nyt	Adjective	ˈnyt
nyy	Noun	ˈnyː
näen	Verb	ˈnæen
näet	Verb	ˈnæet
nähdä	Verb	ˈnæhdæˣ
nähdään	Interjection	ˈnæhdæːn
nähtäneen	Verb	ˈnæctæneːn
nähtävyys	Noun	ˈnæct̪æʋyːs
näiden	Pronoun	ˈnæiden
näitten	Pronoun	ˈnæitːen
näky	Noun	ˈnæky
näkymättömyys	Noun	ˈnækymæˌt̪ːø̞myːs
näkyä	Noun	ˈnækyæ
näkö	Noun	ˈnækø
näköinen	Adjective	ˈnækø̞ine̞n
näköpurppura	Noun	ˈnækøˌpurpːurɑ
nälissään	Adverb	ˈnælisːæːn
nälkä	Noun	ˈnælkæ
nälänhätä	Noun	ˈnælænˌɦætæ
nämä	Pronoun	ˈnæmæ
näpistellä	Verb	ˈnæpiste̞lːæˣ
näre	Noun	ˈnære
näykkiä	Verb	ˈnæykːi.æˣ
näyte	Noun	ˈnæyt̪e̞ˣ
näytellä	Verb	ˈnæytelːæ(ʔ)
näytelmällinen	Adjective	ˈnæy̯telmælːinen
näytetään	Verb	ˈnæytetæːn
näytin	Noun	næytin
näyttelijä	Noun	ˈnæyt̪ːe̞lijæ
näyttelijätär	Noun	ˈnæytːeˌlijætær
näyttäköön	Verb	ˈnæytːækøːn
näyttää	Verb	ˈnæy̯tːæːˣ
näyttäätoteen	Verb	ˈnæytːæː ˈtoteːn
näytös	Noun	ˈnæytøs
nääntyä	Verb	ˈnæːn̪t̪y.æˣ
nörtti	Noun	ˈnø̞rtːi
nöyrä	Adjective	ˈnø̞yræ
ohut	Adjective	ˈohut
oi	Interjection	ɔɪ
oikea	Adjective	ˈo̞ike̞ɑ
oikein	Adverb	ˈo̞ike̞in
oikeudenhalventaminen	Noun	ˈoikeuden ˈhɑlventɑminen
oikeudet	Noun	ˈoikeudet
oikeushammaslääketiede	Noun	ˈoikeusˌɦɑmːɑslæːketːiede(ʔ)
oikeushammaslääkäri	Noun	ˈoikeusˌɦɑmːɑslæːkæri
oikeustieteenkandidaatti	Noun	ˈoikeusˌtieteːŋ ˈkɑndiˌdɑːtːi
oikeustoimi	Noun	ˈoikeusˌtoimi
oikeuteen	Noun	ˈoikeuteːn
oikeutta	Noun	ˈoikeutːɑ
oikeuttaa	Verb	ˈoikeutːɑː(ʔ)
oikoa	Verb	ˈoi̯koɑˣ
oinas	Noun	ˈoinɑs
oio	Verb	ˈo̞ijo̞
oire	Noun	ˈoire(ʔ)
oirehtia	Verb	ˈoirehtiɑ(ʔ)
oireilla	Noun	ˈoireilːɑ
oireyhtymä	Noun	ˈoireʔʔˌyçtymæ
oitis	Adverb	ˈoitis
oiva	Adjective	ˈoiʋɑ
oja	Noun	ˈojɑ
ojentaa	Verb	ˈojentɑːˣ
oka	Noun	ˈɒkə
okluusio	Noun	ˈo̞kluːsio̞
oksennus	Noun	ˈoksenːus
oksennuspallo	Noun	ˈoksenːusˌpɑlːo
oksentaa	Verb	ˈoksen̪t̪ɑː
oksidi	Noun	ˈoksidi
oksitaani	Noun	ˈok.si.ˌtɑː.ni
okulaari	Noun	ˈokulɑːri
ole	Interjection	oˈleɪ
oleen	Verb	ˈoleːn
olemaan	Verb	ˈolemɑːn
olemassaoleva	Adjective	ˈolemɑsːɑˌoleʋɑ
olemasta	Verb	ˈolemɑstɑ
oleminen	Verb	ˈoleminen
olen	Verb	ˈolen
olettaa	Verb	ˈoletːɑː(ʔ)
olettamus	Noun	ˈoletːɑmus
oletus	Noun	ˈoletus
oleutua	Verb	ˈoleutuɑ(ʔ)
oligarkia	Noun	ˈo̞liˌɡɑrki.ɑ
oliivi	Noun	ˈo̞liːʋi
olioohjelmointi	Noun	ˈolio(ʔ)ˌohjelmointi
olisi	Verb	ˈolisi
olka	Noun	ˈo̞lkɑ
olkaa	Verb	ˈolkɑː
olkaamme	Verb	ˈolkɑːmːe
olkineen	Noun	ˈolkineːn
olko	Verb	ˈolko(ʔ)
olkoon	Verb	ˈolkoːn
olkoot	Verb	ˈolkoːt
olla	Noun	ˈɒlə
ollaan	Verb	ˈolːɑːn
ollapullauunissa	Verb	ˈolːɑ ˈpːulːɑ ˈuːnisːɑ
olleet	Verb	ˈolːeːt
olleiden	Verb	ˈolːeiden
olleiksi	Verb	ˈolːeiksi
olleilla	Verb	ˈolːeilːɑ
olleille	Verb	ˈolːeilːe(ʔ)
olleilta	Verb	ˈolːeiltɑ
ollein	Verb	ˈolːein
olleina	Verb	ˈolːeinɑ
olleine	Verb	ˈolːeine
olleisiin	Verb	ˈolːeisiːn
olleissa	Verb	ˈolːeisːɑ
olleista	Verb	ˈolːeistɑ
olleita	Verb	ˈolːeitɑ
olleitta	Verb	ˈolːeitːɑ
olleitten	Verb	ˈolːeitːen
olot	Noun	ˈolot
oltaisiin	Verb	ˈoltɑisiːn
oltaneen	Verb	ˈoltɑneːn
oltavat	Noun	ˈoltɑʋɑt
oltiin	Verb	ˈoltiːn
olut	Noun	ˈolut
oluttupa	Noun	ˈo̞luˌt̪ːupɑ
omaelämäkerta	Noun	ˈomɑˌelæmæˌkertɑ
omaisuus	Noun	ˈomɑisuːs
oman	Adjective	ˈomɑn
omanto	Noun	ˈomɑnto
omantunnontuska	Noun	ˈomɑnˌtunːon ˈtuskɑ
omari	Noun	ˈomɑri
omeletti	Noun	ˈomeletːi
omena	Noun	ˈomenɑ
omenakääriäinen	Noun	ˈomenɑˌkæːriæinen
omikron	Noun	ˈomikron
omistaa	Verb	ˈomistɑː(ʔ)
omistaja	Noun	ˈomistɑjɑ
omistusliite	Noun	ˈomistusˌliːte
ompi	Verb	ˈompi
omppu	Noun	ˈompːu
on	Adjective	ɒn
onania	Noun	ˈonɑniɑ
ongelma	Noun	ˈoŋːelmɑ
ongelmajäte	Noun	ˈoŋːelmɑˌjæte(ʔ)
onkia	Noun	ˈo̞ŋki.ɑ
onkien	Noun	ˈo̞ŋkie̞n
onneksi	Adverb	ˈonːeksi
onni	Noun	ˈonːi
onnistua	Verb	ˈo̞nːistuɑˣ
onnistunut	Adjective	ˈo̞nːistunut̪
onnittelu	Noun	ˈonːitːelu
onteloeläin	Noun	ˈonteloˌelæin
oo	Noun	ˈəʊəʊ
oomega	Noun	ˈoːmeɡɑ
ooppera	Noun	ˈoːpːerɑ
opaali	Noun	ˈopɑːli
opas	Noun	ˈopɑs
ope	Adjective	əʊp
opetella	Verb	ˈopetelːɑ
opettaa	Verb	ˈopetːɑː(ʔ)
opettaja	Noun	ˈopetːɑjɑ
opintopiste	Noun	ˈopintoˌpiste(ʔ)
opintotuki	Noun	ˈopintoˌtuki
opiskeleminen	Noun	ˈopiskeleminen
opiskelijaasunto	Noun	ˈopiskelijɑʔˌɑsunto
opiskelijavaihto	Noun	ˈopiskelijɑˌʋɑihto
oppi	Noun	ˈopːi
oppia	Verb	ˈo̞pːi.ɑˣ
oppilas	Noun	ˈopːilɑs
oppitunti	Noun	ˈopːiˌtunti
ora	Noun	ˈora
oraakkelimainen	Adjective	ˈorɑːˌkːeliˌmɑinen
oralehti	Noun	ˈorɑˌlehti
oranssi	Adjective	ˈorɑnsːi
oranssikaviokuonoyökkö	Noun	ˈorɑnsːiˌkɑʋioˌkuonoˌyøkːø
orapihlajanmarja	Noun	ˈorɑˌpiçlɑjɑˌmːɑrjɑ
orbitaali	Noun	ˈorbitɑːli
orfeuskerttu	Noun	ˈorfeusˌkertːu
origo	Noun	ˈoriɡo
orja	Noun	ˈorjɑ
orjatar	Noun	ˈo̞rjɑt̪ɑr
orkku	Noun	ˈo̞rkːu
ormio	Noun	ˈormio
ornamentti	Noun	ˈornɑmentːi
ornitologi	Noun	ˈornitoloɡi
orpous	Noun	ˈo̞rpo͡us
orvaskesi	Noun	ˈorʋɑsˌkesi
orvokkihopeatäplä	Noun	ˈorʋokːiˌhopeɑˌtæplæ
osaaikainen	Adjective	ˈosɑ(ʔ)ˌɑikɑinen
osallistua	Verb	ˈosɑlːistuɑ(ʔ)
osamäärä	Noun	ˈosɑˌmæːræ
osapuoli	Noun	ˈosɑˌpuoli
oselotti	Noun	ˈo̞se̞lo̞t̪ːi
osittaisdifferentiaaliyhtälö	Noun	ˈositːɑisˌdifːerentiɑːliˌyhtælø
oskillaatio	Noun	ˈoskilːɑːtio
oskillaattori	Noun	ˈoskilːɑːtːori
osma	Noun	ˈo̞smɑ
osmankäämi	Noun	ˈo̞smɑnˌkæːmi
osmansolmu	Noun	ˈosmɑnˌsolmu
osmonsolmu	Noun	ˈosmonˌsolmu
osoite	Noun	ˈosoite(ʔ)
osoittaa	Verb	ˈosoitːɑː(ʔ)
osoittaja	Noun	ˈosoitːɑjɑ
osoittautua	Verb	ˈosoitːɑutuɑ(ʔ)
ossobuco	Noun	ˌɒsəʊ ˈbuːkəʊ
ostaa	Verb	ˈostɑːˣ
ostaja	Noun	ˈostaja
osteoporoosi	Noun	ˈosteoporoːsi
ostettaessa	Verb	ˈostetːɑesːɑ
ostinato	Noun	ɒstɪˈnɑtoʊ
osto	Noun	ˈosto
ostos	Noun	ˈostos
ostovoima	Noun	ˈostoˌʋoimɑ
osua	Verb	ˈosuɑ(ʔ)
osuma	Noun	ˈosumɑ
ota	Adjective	ˈotɑ
otaksuma	Noun	ˈo̞t̪ɑksumɑ
otanta	Noun	ˈo̞t̪ɑn̪t̪ɑ
otava	Noun	ˈotɑʋɑ
ote	Noun	ˈoteˣ
otelauta	Noun	ˈotelˌlɑutɑ
otos	Noun	ˈotos
otsa	Noun	ˈotsɑ
otsalohko	Noun	ˈotsɑˌlohko
ottaa	Verb	ˈotːɑːˣ
ottaahengiltä	Verb	ˈotːɑː ˈhːeŋːiltæ
ottaahuomioon	Verb	ˈotːɑː ˈhːuomioːn
ottaakantaa	Verb	ˈotːɑː ˈkːɑntɑː
ottaalusikkakauniiseenkäteen	Verb	ˈotːɑː ˈlːusikːɑ ˈkɑuniːseːŋ ˈkæteːn
ottaaonkeensa	Verb	ˈotːɑː ˈoŋkeːnsɑ(ʔ)
ottaaselvää	Verb	ˈotːɑː ˈsːelvæː
ottaatodesta	Verb	ˈotːɑː ˈtːodestɑ
ottaavaarin	Verb	ˌotːɑːˈʋːɑːrin
ottaavastaan	Verb	ˈotːɑː ˈʋːɑstɑːn
ottaja	Noun	ˈo̞t̪ːɑjɑ
ottaneet	Verb	ˈotːɑneːt
ottopoika	Noun	ˈotːoˌpoikɑ
otus	Noun	ˈo̞t̪us
ovaali	Adjective	ˈoʋɑːli
ovela	Adjective	ˈoʋelɑ
ovensuukysely	Noun	ˈoʋenˌsuːˌkysely
ovi	Noun	ˈoʋi
ovikello	Noun	ˈoʋiˌkelːo
pehmentää	Verb	ˈpecmentæː(ʔ)
pehmeä	Adjective	ˈpehmeæ
pehmoeläin	Noun	ˈpehmoˌelæin
pehmolelu	Noun	ˈpehmoˌlelu
pehmyt	Adjective	ˈpe̞hmyt̪
peili	Noun	ˈpei̯li
peitsi	Noun	ˈpe̞it̪si
pelailla	Verb	ˈpelɑilːɑ(ʔ)
pelastaa	Verb	ˈpelɑstɑː(ʔ)
peli	Noun	ˈpeli
pelikello	Noun	ˈpeliˌkelːo
pelimies	Noun	ˈpe̞liˌmie̞s
pelko	Noun	ˈpe̞lko̞
pelle	Verb	ˈpelːe
peloissaan	Adverb	ˈpeloisːɑːn
pelästyä	Verb	ˈpelæstyæ(ʔ)
pelätä	Verb	ˈpelætæ(ʔ)
penetroida	Verb	ˈpe̞ne̞t̪ro̞idɑˣ
penikuorma	Noun	ˈpeniˌkuo̯rmɑ
peninkulma	Noun	ˈpe̞ninˌkulmɑ
penkkiurheilu	Noun	ˈpeŋkːiˌurheilu
pensaskoira	Noun	ˈpe̞n̪sɑsˌko̞irɑ
pentteri	Noun	ˈpentːeri
pentu	Noun	ˈpe̞n̪t̪u
perata	Verb	ˈpe̞rɑt̪ɑ(ʔ)
perenna	Noun	ˈperenːɑ
perhe	Noun	ˈperheˣ
periaate	Noun	ˈperiˌɑːte(ʔ)
perijätär	Noun	ˈperiˌjætær
perinne	Noun	ˈperinːe(ʔ)
perintä	Noun	ˈpe̞rin̪t̪æ
perintätoimisto	Noun	ˈpe̞rin̪t̪æˌt̪o̞imisto̞
periä	Verb	ˈpe̞riæˣ
perjantai	Noun	ˈperjɑntɑi̯
perkeet	Noun	ˈperkeːt
permitiivisyys	Noun	ˈpe̞rmiˌt̪ːiʋisyːs
perna	Verb	pernə
perse	Noun	ˈpe̞rse̞ˣ
perseennuolija	Noun	ˈpe̞rse̞ːnˌnuɔlijɑ
persialainen	Noun	ˈpersiɑlɑinen
persilja	Noun	ˈpersiljɑ
personaltrainer	Noun	ˈpe̞rso̞nɑl ˈtre̞ine̞r
persoona	Noun	ˈpersoːnɑ
persus	Noun	ˈpe̞rsus
peruna	Noun	ˈpe̞runɑ
perunajauho	Noun	ˈperunɑˌjɑuɦo
perunarutto	Noun	ˈperunɑˌrutːo
peruskallio	Noun	ˈperusˌkɑlːio
peruskoulu	Noun	ˈpe̞rusˌko̞ulu
peruste	Noun	ˈpe̞ruste̞ˣ
perustua	Verb	ˈperustuɑ(ʔ)
perustus	Noun	ˈperustus
perämies	Noun	ˈperæˌmies
peräsin	Noun	ˈperæsin
pesissä	Noun	ˈpe̞sisːæ
pestä	Verb	ˈpestæ(ʔ)
pesu	Verb	ˈpesu
pesuallas	Noun	ˈpe̞suˌɑlːɑs
pesue	Noun	ˈpesu.e
pesukarhu	Noun	ˈpesuˌkɑrxu
pesukone	Noun	ˈpesuˌkone(ʔ)
pesusieni	Noun	ˈpesuˈsieni
pesusienikurkku	Noun	ˈpesuˈsieniˈkurkːu
pesä	Noun	ˈpesæ
pesäkekovettumatauti	Noun	ˈpesækeˌkːoʋetːumɑˌtɑuti
pesäpallo	Noun	ˈpesæˌpɑlːo
petankki	Noun	ˈpe̞t̪ɑŋkːi
petoeläin	Noun	ˈpetoˌelæin
petos	Verb	ˈpetos
petrimalja	Noun	ˈpetriˌmɑljɑ
petroli	Noun	ˈpetroli
petsi	Noun	ˈpe̞t̪si
pettu	Noun	ˈpetːu
pettuleipä	Noun	ˈpetːuˌleipæ
pettää	Verb	ˈpetːæː(ʔ)
petyn	Verb	ˈpetyn
pianokoulu	Noun	ˈpiɑnoˌkoulu
pianomusiikki	Noun	iːkːi
pianooppilas	Noun	ˈpiɑnoˌopːilɑs
pidellä	Verb	ˈpide̞lːæˣ
pidät	Verb	ˈpidæt̪
pidättyväinen	Adjective	ˈpidæːtyvæinen
pidättyväisyys	Noun	ˈpidæːtyvæisyːs
pidättää	Verb	ˈpidætːæː(ʔ)
pidätyskyky	Noun	ˈpidætysˌkyky
pieniä	Adjective	ˈpieniæ
pienjännite	Noun	piɛnjænːite
pienoisjännite	Noun	pienɔisjænːite
pienoiskoko	Noun	ˈpie̞no̞isˌko̞ko̞
pienoismalli	Noun	ˈpienoisˌmɑlːi
pienuus	Noun	ˈpi͡enuːs
piestä	Noun	ˈpiestæ
piha	Noun	ˈpiɦɑ
pihi	Adjective	ˈpiɦi
pihiä	Adjective	ˈpiɦi.æ
pii	Noun	ˈpiː
piika	Noun	ˈpiːkɑ
piikkari	Noun	ˈpiːkːɑri
piikki	Noun	ˈpiːkːi
piikoa	Verb	ˈpiːko̞.ɑˣ
piilevä	Adjective	ˈpiːleʋæ
piilo	Noun	ˈpiːlo
piilokamera	Noun	ˈpiːlo̞ˌkɑme̞rɑ
piilolinssi	Noun	ˈpiːloˌlinsːi
piilukko	Noun	ˈpiːˌlukːo
piimä	Noun	ˈpiːmæ
piina	Noun	ˈpiːnɑ
piinata	Verb	ˈpiːnɑtɑˣ
piirakka	Noun	ˈpiːrɑkːɑ
piiras	Noun	ˈpiːrɑs
piirilevy	Noun	ˈpiːriˌleʋy
piironki	Noun	ˈpiːroŋki
piirrosanimaatio	Noun	ˈpiːrːosˌɑnimɑːtio
piirroselokuva	Noun	ˈpiːrːosˌeloˌkuʋɑ
piirrosfilmi	Noun	ˈpiːrːosˌfilmi
piiru	Noun	ˈpiːru
piirustus	Noun	ˈpiːrustus
piispatar	Noun	ˈpiːspɑtɑr
pikkuauto	Noun	ˈpikːuˌɑuto̞
pikkukiivi	Noun	ˈpikːuˌkiːʋi
pikkukylä	Noun	ˈpikːuˌkylæ
pikkulintu	Noun	ˈpikːuˌlintu
pikkuruinen	Adjective	ˈpikːuruine̞n
pikkusormi	Noun	ˈpikːuˌsormi
pikkuvarpunen	Noun	ˈpikːuˌʋɑrpunen
pikkuyksiö	Noun	ˈpikːuˌyksiø
pikosekunti	Noun	ˈpikosekunti
pikti	Noun	ˈpʰɪʰktɪ
pila	Noun	ˈpilɑ
pilke	Noun	ˈpilkeˣ
pilkku	Noun	ˈpilkːu
pilkunnussija	Noun	ˈpilkunˌnusːijɑ
pilli	Noun	ˈpilː.i
pilssipumppu	Noun	ˈpilsːiˌpumpːu
pilttuu	Noun	ˈpil̪t̪ːuː
pilvenpiirtäjä	Noun	ˈpilʋenˌpiːrtæjæ
pilvetön	Adjective	ˈpilʋe̞t̪ø̞n
pimeä	Adjective	ˈpime̞.æ
pinkki	Adjective	ˈpinkːi
pinnaaja	Noun	ˈpinːɑːjɑ
pinnari	Noun	ˈpinːɑri
pino	Noun	ˈpino
pinssi	Noun	ˈpinsːi
pintajännitys	Noun	ˈpintɑˌjænːitys
piparkakku	Noun	ˈpipɑrˌkɑkːu
pipo	Noun	ˈpi.poː
pippuri	Noun	ˈpipːuri
piraija	Noun	ˈpirɑijːɑ
pirssi	Noun	ˈpirsːi
pirteä	Adjective	ˈpirte̞.æ
pirtu	Noun	ˈpirtu
piru	Noun	ˈpiru
pisama	Noun	ˈpisɑmɑ
pisara	Noun	ˈpisɑrɑ
pissaliisa	Noun	ˈpisːɑˌliːsɑ
pisto	Noun	ˈpisto
pistoke	Noun	ˈpistokeˣ
pistäkää	Verb	ˈpistækæː
pitchi	Noun	ˈpitʃi
piti	Verb	ˈpit̪i
pitkähäntämuurahaiskäpy	Noun	ˈpitkæˌhæntæˌmuːrɑhɑisˌkæpy
pitkämiekka	Noun	ˈpitkæˌmiekːɑ
pitkäperjantai	Noun	ˈpitkæˌperjɑntɑi̯
pitkäsäärinen	Adjective	ˈpitkæˌsæːrinen
pito	Noun	ˈpito
pitseria	Noun	ˈpitseriɑ
pitsi	Noun	ˈpitsi
pituushyppy	Noun	ˈpit̪uːsˌcypːy
pituusyksikkö	Noun	ˈpituːsˌyksikːø
pitää	Verb	ˈpitæːˣ
pitäähallussaan	Verb	ˈpitæːˣ ˈhːɑlːusːɑni
pitäähuolta	Verb	ˈpitæːˣ ˈɦːuoltɑ
pitäävaransa	Verb	ˈpitæːˌ ʋːɑrɑni
pitääyhtä	Verb	ˈpitæːˣ ˈyɦtæ
pitääyllä	Verb	ˈpitæːˣ ˈylːæ
pivo	Noun	pɪvo
plakki	Noun	ˈplɑkːi
playboy	Noun	ˈpleɪˌbɔɪ
plektra	Noun	ˈplektrɑ
plikka	Noun	ˈplikːɑ
ploki	Noun	ˈplo̞ki
plusmerkki	Noun	ˈplusˌmerkːi
pohatta	Noun	ˈpoɦɑtːɑ
pohja	Noun	ˈpohjɑ
pohjalukema	Noun	ˈpo̞xjɑˌluke̞mɑ
pohje	Noun	ˈpo̞xje̞ˣ
pohjeluu	Noun	ˈpoxjelˌluː
pohjoinen	Noun	ˈpohjoinen
pohtia	Verb	ˈpohtiɑ
poiju	Noun	ˈpoiju
poika	Noun	ˈpoi̯kɑ
poikamies	Noun	ˈpoikɑˌmies
poikaystävä	Noun	ˈpoikɑˌystæʋæ
poikia	Verb	ˈpo̞iki.ɑˣ
poikkihuilu	Noun	ˈpoikːiˌxuilu
poimu	Noun	ˈpo̞imu
poimuttaa	Verb	ˈpoimutːɑː(ʔ)
poimuttua	Verb	ˈpoimutːuɑ(ʔ)
pointteri	Noun	ˈpointːeri
pointti	Noun	ˈpointːi
poissaolo	Noun	ˈpoisːɑˌolo
poistaa	Verb	poistɑː
poisto	Noun	ˈpoisto
pokeri	Noun	ˈpokeri
pola	Adjective	ˈpolɑ
polarisoida	Verb	ˈpolɑriˌsoidɑ(ʔ)
polarisoitua	Verb	ˈpolɑrisoituɑ(ʔ)
polaroida	Verb	ˈpolɑroidɑ(ʔ)
polaroitua	Verb	ˈpolɑroituɑ(ʔ)
poliisi	Noun	ˈpo̞liːsi
poliisimies	Noun	ˈpoliːsiˌmies
poliittinen	Adjective	ˈpoliːtːinen
poliittisesti	Adverb	ˈpoliːtːiˌsesti
poljin	Noun	ˈpoljin
polkea	Verb	ˈpo̞lke̞.ɑˣ
polkka	Noun	ˈpo̞lkːɑ
polkupyörä	Noun	ˈpolkuˌpyø̯ræ
pollari	Noun	ˈpolːɑri
pollina	Noun	puˈʎi.nə
polo	Noun	ˈpoʊloʊ
poloneesi	Noun	ˈpo̞lo̞ne̞ːsi
polte	Noun	ˈpo̞l̪t̪e̞ˣ
poltin	Noun	ˈpo̞ltin
polttarit	Noun	ˈpoltːɑrit
poltteet	Noun	ˈpo̞l̪t̪ːe̞ːt̪
polttomerkitä	Verb	ˈpoltːoˌmerkitæˣ
polttopullo	Noun	ˈpo̞lt̪ːo̞ˌpulːo̞
polvi	Noun	ˈpolʋi
polvitaive	Noun	ˈpo̞lʋiˌt̪ɑiʋe̞
pommi	Noun	ˈpomːi
pomo	Adjective	ˈpo.mo
pompi	Verb	ˈpo̞mpiˣ
pomppia	Verb	ˈpo̞mpːi.ɑˣ
ponsi	Noun	ˈponsi
poppa	Noun	ˈpɒpə
poppamies	Noun	ˈpopːɑˌmies
poppoo	Noun	ˈpopːoː
popularisoida	Verb	ˈpopulɑriˌsoidɑ(ʔ)
porkkana	Noun	ˈporkːɑnɑ
pornografinen	Adjective	ˈpornoˌɡrɑfinen
poronkusema	Noun	ˈpo̞ro̞nˌkuse̞mɑ
poropeukalo	Noun	ˈporoˌpeukɑlo
porrasperä	Noun	ˈporːɑsˌperæ
porsas	Noun	ˈporsɑs
porstua	Noun	ˈporstuɑ
portata	Adjective	ˈportɑtɑ
porukka	Noun	ˈporukːɑ
positroni	Noun	ˈpositroni
poskiontelontulehdus	Noun	ˈposkiˌontelonˌtulehdus
poskipuna	Noun	ˈpo̞skiˌpunɑ
posliini	Noun	ˈposliːni
posliinikauppa	Noun	ˈposliːniˌkɑu̯pːɑ
possessiivipronomini	Noun	ˈposːesːiːviˌpronomini
possessiivisuffiksi	Noun	ˈposːesːiːviˌsufːiksi
possu	Noun	ˈposːu
postiluukku	Noun	ˈpostiˌluːkːu
postimerkki	Noun	ˈpostiˌmerkːi
postimies	Noun	ˈpostiˌmies
postpositio	Noun	ˈpostˌpositio
potea	Verb	ˈpoteɑ(ʔ)
potentiometri	Noun	ˈpo̞t̪e̞n̪t̪io̞ˌme̞t̪ri
potikka	Noun	ˈpotikːa
potkaista	Verb	ˈpo̞t̪kɑistɑˣ
potkaistatyhjää	Verb	ˈpotkɑistɑ ˈtːyhjæː
potki	Verb	ˈpo̞t̪ki
potkia	Noun	ˈpotkiɑ
potta	Noun	ˈpotːɑ
pottu	Noun	ˈpotːu
poukama	Noun	ˈpou̯kɑmɑ
pouta	Noun	ˈpoutɑ
povaaja	Noun	ˈpoʋɑːjɑ
povi	Verb	ˈpovi
preesens	Noun	ˈpre̞ːse̞ns
prejudikaatti	Noun	preˈjudiˌkɑːtːi
prepositio	Noun	ˈprepositio
prepositionaali	Noun	ˈprepositionɑːli
prikaatikenraali	Noun	ˈprikɑːt̪iˌke̞nrɑːli
prinssi	Noun	ˈprinsːi
printti	Noun	ˈprintːi
professori	Noun	ˈpro̞fe̞sːo̞ri
prokura	Noun	ˈpro̞kurɑ
prokuura	Noun	ˈpro̞kuːrɑ
propaani	Noun	ˈpropɑːni
propaganda	Noun	ˌpɹɒpəˈɡændə
propuska	Noun	ˈproːpuskɑ
prostituutio	Noun	ˈprostiˌtuːtio
protokolla	Noun	ˈprotokolːɑ
provosoitua	Verb	ˈproʋosoi̯tuɑˣ
pruutta	Noun	ˈpruːtːɑ
prätkä	Noun	ˈpræt̪kæ
pseudepigrafi	Noun	ˈpseudˌepiɡrɑfi
psii	Noun	ˈpsiː
psykiatri	Noun	ˈpsykiɑtri
psykiatria	Noun	ˈpsykiɑtriɑ
psykoosi	Noun	ˈpsykoːsi
psyyke	Noun	ˈpsyːke̞
puhallin	Noun	ˈpuhɑlːin
puhdas	Adjective	ˈpuɦdɑs
puhe	Noun	ˈpuɦe(ʔ)
puheenjohtaja	Noun	ˈpuɦe̞ːnˌjo̞xt̪ɑjɑ
puheenvuoro	Noun	ˈpuɦeːnˌʋuɔro
puheli	Verb	ˈpuɦeli
puhelin	Noun	ˈpuɦelin
puhelinkeskus	Noun	ˈpuɦe̞linˌke̞skus
puhelinluettelo	Noun	ˈpuɦe̞linˌlue̞t̪ːe̞lo̞
puhelinnumero	Noun	ˈpuɦe̞linˌnume̞ro̞
puhelinsoitto	Noun	ˈpuɦe̞linˌso̞it̪ːo̞
puhelinvaihde	Noun	ˈpuɦe̞linˌʋɑixde̞
puhelinvastaaja	Noun	ˈpuɦe̞linˌʋɑstɑːjɑ
puhella	Verb	ˈpuhelːɑ(ʔ)
puhelu	Noun	ˈpuɦelu
puhemies	Noun	ˈpuɦeˌmːies
puhevika	Noun	ˈpuɦeˌʋːikɑ
puhjeta	Verb	ˈpuxjetɑ(ʔ)
puhkoa	Verb	ˈpuxkoɑ(ʔ)
puhu	Verb	ˈpuɦuˣ
puhuasuunsapuhtaaksi	Verb	ˈpuɦuɑˈ sːuːnsɑ ˈpːuɦtɑːksi
puhutkosuomea	Phrase	ˈpuɦutko ˈsuɔmeɑ
puhutteleva	Verb	ˈpuhutːelevɑ
puida	Verb	ˈpuidɑ(ʔ)
puikea	Adjective	ˈpuikeɑ
puikelo	Noun	ˈpuikelo
puikko	Noun	ˈpuikːo
puisto	Noun	ˈpuisto̞
puit	Noun	pœy̯t
pukea	Verb	ˈpukeɑ(ʔ)
pukeutua	Verb	ˈpuke̞ut̪u.ɑˣ
pukki	Noun	ˈpukːi
puku	Noun	ˈpuːkuː
pulisongit	Noun	ˈpulisoŋːit
pulista	Verb	ˈpulistɑ(ʔ)
pulittaa	Verb	ˈpulitːɑː(ʔ)
pulkka	Noun	ˈpulkːɑ
pulla	Noun	ˈpulːɑ
pullakko	Noun	ˈpulːɑkːo
pullonpohjalasi	Noun	ˈpulːonˌpohjɑˌlɑsi
pullulaani	Noun	ˈpulːulɑːni
pulma	Noun	ˈpulmɑ
pulsari	Noun	ˈpulsɑri
pulu	Noun	ˈpulu
pumpernikkeli	Noun	ˈpumpe̞rˌnikːe̞li
punahilkkaaratti	Noun	ˈpunɑˌhilkːɑ(ʔ)ˌɑrɑtːi
punainen	Adjective	ˈpunɑi̯nen
punakaali	Noun	ˈpunɑˌkɑːli
punapuu	Noun	ˈpunɑˌpuː
punavihersokeus	Noun	ˈpunɑˌʋiɦerˌsokeus
punkki	Noun	puŋkːi
punssi	Noun	ˈpunsːi
puola	Noun	ˈpuolɑ
puolapuu	Noun	ˈpuɔlɑˌpuː
puoli	Adjective	ˈpuɔli
puolialaston	Adjective	ˈpuɔliˌɑlɑston
puoliapina	Noun	ˈpuɔliˌɑpinɑ
puoliintumisaika	Noun	ˈpuɔliːn̪t̪umisˌɑikɑ
puolijohde	Noun	ˈpuoliˌjoxde(ʔ)
puolijumala	Noun	ˈpuɔliˌjumɑlɑ
puolikypsä	Adjective	ˈpuɔliˌkypsæ
puolillaan	Adverb	ˈpuo̯lilːɑːn
puolipiste	Noun	ˈpuoliˌpiste(ʔ)
puoliso	Noun	ˈpuɔliso
puolla	Verb	ˈpuolːɑ
puoltaa	Verb	ˈpuoltɑː
puolue	Noun	ˈpuɔlu.e̞ˣ
puolukka	Noun	ˈpuolukːɑ
puomi	Noun	ˈpuomi
puosu	Noun	ˈpuɔsu
pupu	Noun	ˈpupu
purasruoho	Noun	ˈpurɑsˌruɔɦo
pureksia	Verb	ˈpure̞ksi.ɑˣ
pureutua	Verb	ˈpureutuɑ(ʔ)
puristella	Verb	ˈpuriste̞lːɑˣ
purje	Noun	ˈpurje̞ˣ
purjehdus	Noun	ˈpurje̞hdus
purjehtia	Verb	ˈpurje̞ht̪iɑˣ
purjevene	Noun	ˈpurje̞ˌʋːe̞ne̞ˣ
purjo	Noun	ˈpurjo
purkinavaaja	Noun	ˈpurkinˌɑʋɑːjɑ
purppura	Adjective	ˈpurpːurɑ
purra	Noun	ˈpʰʊɹːa
pursimies	Noun	ˈpursiˌmie̞s
purskahtaa	Verb	ˈpurskɑhtɑː(ʔ)
pursua	Verb	ˈpursuɑˣ
purut	Noun	ˈpurut̪
purée	Noun	ˈpyreː
pusata	Verb	ˈpusɑtɑˣ
puskea	Verb	ˈpuske̞ɑˣ
puskin	Noun	ˈpuskin
pussailu	Noun	ˈpusːɑilu
pussata	Verb	ˈpusːɑtɑˣ
pussieläin	Noun	ˈpusːi.ˌelæin
pussijuoksu	Noun	ˈpusːiˌjuɔksu
pussittaa	Verb	ˈpusːitːɑːˣ
pusu	Noun	ˈpusu
pusukala	Noun	ˈpusuˌkɑlɑ
putka	Noun	ˈputkɑ
putkilo	Noun	ˈputkilo
putkilokasvi	Noun	ˈputkiloˌkɑsʋi
putkimies	Noun	ˈput̪kiˌmies
putkiremontti	Noun	ˈputkiˌremontːi
putkisolu	Noun	ˈputkiˌsolu
puu	Noun	ˈpuː
puucee	Noun	ˈpuːˌseː
puuhka	Noun	ˈpuːxkɑ
puukiipijä	Noun	ˈpuːˌkiːpijæ
puukko	Noun	ˈpuːkːo̞
puukottaja	Noun	ˈpuːkotːɑjɑ
puulla	Noun	ˈpuːlːɑ
puunaama	Verb	ˈpuːnɑːmɑ
puunkuori	Noun	ˈpuːŋˌkuɔri
puuska	Noun	ˈpuːskɑ
puutarhaletku	Noun	ˈpuːˌtɑrɦɑˌletku
puute	Noun	ˈpuːteˣ
puuteri	Noun	ˈpuːt̪e̞ri
puuton	Adjective	ˈpuːton
puutua	Verb	ˈpuːt̪u.ɑ
puuvilla	Noun	ˈpuːˌʋilːɑ
pyhimys	Noun	ˈpyɦimys
pyhisin	Adverb	ˈpyhisin
pyhä	Adjective	ˈpyhæ
pyhäinmiestenpäivä	Noun	ˈpyɦæinˌmie̞ste̞nˌpæiʋæ
pyhäinpäivä	Noun	ˈpyɦæinˌpæiʋæ
pyjama	Noun	piˈjaːmaː
pykiä	Verb	ˈpyki.æˣ
pyree	Noun	ˈpyre̞ː
pyrkiä	Verb	ˈpyrki.æˣ
pyry	Noun	ˈpyry
pysty	Verb	ˈpysty(ʔ)
pystyillä	Verb	ˈpystyilːæ(ʔ)
pystyyn	Adverb	ˈpːystyːn
pysyä	Verb	ˈpysyæ(ʔ)
pyy	Noun	ˈpyː
pyyhkiä	Verb	ˈpyːçki.æˣ
pyykki	Noun	ˈpyːkːi
pyykkipoika	Noun	ˈpyːkːiˌpo̞ikɑ
pyykkääminen	Noun	ˈpyːkːæːˌminen
pyyntilonkero	Noun	ˈpyːntiˌloŋkero
pyytää	Verb	ˈpyːtæːˣ
pyytääanteeksi	Verb	ˈpyːtæː(ʔ) ˈɑnteːksi
pyöriö	Noun	ˈpyø̞riø̞
pyörtyä	Verb	ˈpyørtyæ
pähkylä	Noun	ˈpæçkylæ
päihde	Noun	ˈpæiçdeˣ
päissään	Noun	ˈpæisːæːn
päivystys	Noun	ˈpæiʋystys
päivä	Noun	ˈpæi̯ʋæ
päiväkirja	Noun	ˈpæiʋæˌkirjɑ
päivällisaika	Noun	ˈpæi̯ʋælːisˌɑi̯kɑ
päivänseisaus	Noun	ˈpæivænˌseisɑus
päiväntasaaja	Noun	ˈpæiʋænˌt̪ɑsɑːjɑ
päiväntasaus	Noun	ˈpæivænˌtɑsɑus
päiväuni	Noun	ˈpæiʋæˌuni
päivää	Noun	ˈpæiʋæː
päkiä	Noun	ˈpækiæ
pärstäkerroin	Noun	ˈpærstæˌkerːoin
pätkiä	Noun	ˈpætkiæ
pätsi	Noun	ˈpætsi
pää	Noun	pæː
pääkallo	Noun	ˈpæːˌkɑlːo
pääkallokiitäjä	Noun	ˈpæːˌkɑlːoˌkiːtæjæ
päälle	Noun	ˈpæːlːe(ʔ)
päältä	Noun	ˈpæːltæ
pääluottamusmies	Noun	ˈpæːˌluɔt̪ːɑmusˌmies
päämies	Noun	ˈpæːˌmie̞s
päämäärä	Noun	ˈpæːˌmæːræ
päänsärky	Noun	ˈpæːnˌsærky
pääsky	Noun	ˈpæːsky
päästääpäiviltä	Verb	ˈpæːstæːˌ pːæiviltæ
päästö	Noun	ˈpæːstø
päätavoite	Noun	ˈpæːˌt̪ɑʋoit̪e
päätellä	Verb	ˈpæːtelːæ(ʔ)
päättyvä	Adjective	ˈpæːtːyʋæ
päättää	Verb	ˈpæːtːæː
pääverbi	Noun	ˈpæːˌʋerbi
pöhö	Noun	ˈpø̞ɦø̞
pökertyä	Verb	ˈpø̞ke̞rtyæˣ
pöllämystynyt	Adjective	ˈpølːæmystynyt
pöllö	Noun	ˈpølːø
pöly	Noun	ˈpøly
pölynimuri	Noun	ˈpølynˌimuri
pölytys	Noun	ˈpølytys
pösö	Noun	ˈpø̞sø̞
pötki	Verb	ˈpø̞t̪ki
pötsi	Noun	ˈpøtsi
pöytye	Noun	ˈpøytye
pöytä	Noun	ˈpøytæ
pöytävuori	Noun	ˈpøytæˌʋuɔri
rakastellen	Verb	ˈrɑkɑstelːen
rakastelu	Noun	ˈrɑkɑstelu
rakastua	Verb	ˈrɑkɑstuɑ(ʔ)
raki	Noun	ˈɹækə
rakka	Noun	ˈrɑkːɑ
rakkaus	Noun	ˈrɑkːɑu̯s
rakki	Noun	ˈrɑkːi
rakko	Noun	ˈrɑkːo
rako	Noun	ˈrɑko
rakuuna	Noun	ˈrɑkuːnɑ
ralli	Noun	ˈrɑlːi
rampa	Noun	ˈrɑmpɑ
rangaista	Verb	ˈrɑŋːɑistɑ(ʔ)
rangaistuspotku	Noun	ˈrɑŋːɑistusˌpotku
ranka	Noun	ˈrɑŋkɑ
rankaista	Verb	ˈrɑŋkɑistɑ(ʔ)
rankata	Verb	ˈrɑŋkɑt̪ɑ
ranne	Noun	ˈrɑnːeˣ
rannekanava	Noun	ˈrɑnːeˌkɑnɑʋɑ
ranta	Noun	ˈrɑn̪t̪ɑ
rantaa	Noun	ˈrɑntɑː
rantautua	Verb	ˈrɑn̪t̪ɑut̪uɑˣ
raottaa	Verb	ˈrɑo̞t̪ːɑːˣ
rap	Noun	ɹæp
raparperi	Noun	ˈrɑpɑrperi
rapista	Verb	ˈrɑpistɑ(ʔ)
rapmusiikki	Noun	ˈrɑpˌmusiːkːi
rappeutua	Verb	ˈrɑpːeuˌtuɑ
rappio	Noun	ˈrɑpːio
rapsi	Noun	ˈrɑpsi
rapsinsiemen	Noun	ˈrɑpsinˌsiemen
rapsutin	Noun	ˈrɑpsutin
rapu	Noun	ˈrɑpu
rasagiliini	Noun	ˈrɑsɑɡiˌliːni
rasemisaatio	Noun	ˈrɑsemiˌsɑːtio
rasioita	Noun	ˈrɑsioitɑ
rasismi	Noun	ˈrɑsismi
rasittaa	Verb	ˈrɑsitːɑːˣ
raskaana	Adverb	ˈrɑskɑːnɑ
raskaudenkeskeytys	Noun	ˈrɑskɑudeŋˌkeskeytys
raskaus	Noun	ˈrɑskɑus
raskausarpi	Noun	ˈrɑskɑusˌɑrpi
raskia	Verb	ˈrɑskiɑˣ
rastas	Noun	ˈrɑstɑs
rastuli	Noun	ˈrɑstuli
rasvaa	Noun	ˈrɑsvɑː
rasvakala	Noun	ˈrɑsʋɑˌkɑlɑ
rata	Noun	ˈra.tə
ratamestari	Noun	ˈrɑtɑˌmestɑri
ratas	Noun	ˈrɑtɑs
ratsia	Noun	ˈrɑtsiɑ
ratsu	Noun	ˈrɑtsu
ratti	Noun	ˈrɑtːi
rauhanen	Noun	ˈrɑuɦɑne̞n
rauhanomainen	Noun	ˈrɑuɦɑnˌomɑinen
raunikki	Noun	ˈrɑunikːi
rauta	Noun	ˈrɑu̯tɑ
rautakauppa	Noun	ˈrɑu̯tɑˌkɑu̯pːɑ
rautatavara	Noun	ˈrɑutɑˌtɑʋɑrɑ
rautatie	Noun	ˈrɑutɑˌtie
rautiainen	Noun	ˈrɑutiɑinen
ravinne	Noun	ˈrɑʋinːe(ʔ)
ravintoketju	Noun	ˈrɑʋintoˌketju
ravintola	Noun	ˈrɑʋintolɑ
ravistaa	Verb	ˈrɑʋistɑː(ʔ)
ravit	Noun	ˈrɑʋit
reaaliaikainen	Adjective	ˈre̞ɑːliˌɑikɑin̪e̞n̪
reaalipääoma	Noun	ˈreɑːliˌpæːomɑ
realistinen	Adjective	ˈreɑlistinen
realistisesti	Adverb	ˈreɑlistiˌsesti
realiteetti	Noun	ˈreɑliteːtːi
referee	Noun	ˌɹɛf.əˈɹiː
refleksi	Noun	ˈrefleksi
reformi	Verb	ˈreformi
regeneraatio	Noun	ˈreɡeneˌrɑːtio
reggae	Noun	ˈɹɛɡeɪ
rehabilitaatio	Noun	ˈrehɑbiliˌtɑːtio
rehellinen	Adjective	ˈrehelːinen
rehellisesti	Adverb	ˈre̞ɦe̞lːise̞st̪i
rehevöityminen	Noun	ˈreheʋøityminen
rehevöityä	Verb	ˈreheˌʋøityæ(ʔ)
rehtori	Noun	ˈre̞ht̪o̞ri
rehu	Noun	ˈre̞ɦu
reilu	Adjective	ˈre̞ilu
reima	Adjective	ˈrei̯mɑ
reisi	Noun	ˈreisi
rei’itin	Noun	ˈre̞ijit̪in
reki	Noun	ˈreki
rekisterikilpi	Noun	ˈrekisteriˌkilpi
rekisteriote	Noun	ˈrekisteriˌoteˣ
rekisteröidä	Verb	ˈre̞kiste̞rø̞idæˣ
rekisteröinti	Noun	ˈre̞kist̪e̞rø̞in̪t̪i
rekkaauto	Noun	ˈre̞kːɑʔˌɑut̪o̞
reklamaatio	Noun	ˈreklɑmɑːtio
rekonstruktio	Noun	ˈrekonstruktio
rekvisiitta	Noun	ˈrekʋisiːtːɑ
rekyyli	Noun	ˈrekyːli
relaatiotietokanta	Noun	ˈrelɑːtioˌtietoˌkɑntɑ
relativistinen	Adjective	ˈrelɑtiˌʋistinen
relevantti	Adjective	ˈreleˌvantːi
remontti	Noun	ˈre̞mo̞n̪t̪ːi
renessanssi	Noun	ˈrenesːɑnsːi
rengas	Noun	ˈre̞ŋːɑs
rengasjärjestelmä	Noun	ˈreŋːɑsˌjærjestelmæ
rengasmainen	Adjective	ˈre̞ŋːɑsˌmɑine̞n
rento	Verb	ˈrento
rentouttaa	Verb	ˈrentout̪ːɑː
rentoutua	Verb	ˈrentoutuɑ
rentoutus	Noun	ˈrentoutus
rentukka	Noun	ˈrentukːɑ
repertoaari	Noun	ˈreperto̞ɑːri
repi	Verb	ˈre̞pi
repiä	Verb	ˈre̞pi.æˣ
repliikki	Noun	ˈrepliːkːi
repo	Noun	ˈɹiːpoʊ
repolarisaatio	Noun	ˈrepolɑriˌsɑːtio
reppana	Noun	ˈrepːɑnɑ
reppu	Noun	ˈrepːu
reppumatkaaja	Noun	ˈrepːuˌmɑtkɑːjɑ
reseptilääke	Noun	ˈreseptiˌlæːkeˣ
reserviupseerikoulu	Noun	ˈreserviupseːriˌkoulu
resiina	Noun	ˈresiːnɑ
resupekka	Noun	ˈresuˌpekːɑ
retiisi	Noun	ˈretiːsi
retikka	Noun	ˈretikːɑ
retkeilijä	Noun	ˈretkeilijæ
retki	Noun	ˈretki
retkikunta	Noun	ˈre̞tkiˌkun̪t̪ɑ
revi	Verb	ˈre̞ʋiˣ
revontulet	Noun	ˈre̞ʋo̞n̪ˌt̪ule̞t̪
revähdys	Noun	ˈre̞ʋæcdys
rhoo	Noun	ˈroː
riehuminen	Noun	ˈrieɦuminen
riemukkaat	Adjective	ˈrie̞mukːɑːt̪
rienata	Verb	ˈrienata
riesa	Noun	ˈrie̯sɑ
rieska	Noun	ˈrieskɑ
riidellä	Verb	ˈriːde̞lːæˣ
riippuen	Preposition	ˈriːpːuen
riisi	Noun	ˈriːsi
riisihärö	Noun	ˈriːsiˌhærø
riisipelto	Noun	ˈriːsiˌpelto
riisto	Noun	ˈriːsto
riistää	Verb	ˈriːstæːˣ
riisuuntua	Verb	ˈriːsuːn̪t̪u.ɑˣ
riitasointu	Noun	ˈriːtɑˌsointu
riitti	Noun	ˈriːtːi
riittämätön	Adjective	ˈriːtːæmætøn
riittää	Verb	ˈriːtːæː(ʔ)
riiuuyöaie	Noun	ˈriːuːˌyøˌɑieˣ
riivata	Verb	ˈriivata
rikastaa	Verb	ˈrikɑstɑː(ʔ)
rike	Noun	ˈrike(ʔ)
rikka	Noun	ˈrikːɑ
rikkalapio	Noun	ˈrikːɑˌlɑpio̞
rikkaruoho	Noun	ˈrikːɑˌruɔɦo̞
rikki	Noun	ˈrikːi
rikkivety	Noun	ˈrikːiˌʋety
rikkiyhdiste	Noun	ˈrikːiˌycdiste(ʔ)
rikkomaton	Adjective	ˈrikːomɑton
rima	Noun	ˈrimɑ
rimpi	Noun	ˈrimpi
rimpuilla	Verb	ˈrimpuilːɑ(ʔ)
rinkeli	Noun	ˈriŋkeli
rinne	Noun	ˈrinːe̞ˣ
rinta	Noun	ˈrin̪t̪ɑ
rintaevä	Noun	ˈrin̪t̪ɑˌe̞ʋæ
rintakehä	Noun	ˈrintɑˌkehæ
rintaliivit	Noun	ˈrintɑˌliːʋit
rintauinti	Noun	ˈrintɑˌuinti
ripaska	Noun	ˈripɑskɑ
ripaus	Noun	ˈripɑus
ripsi	Noun	ˈripsi
ripsiväri	Noun	ˈripsiˌʋæri
ripuli	Noun	ˈripuli
risteillä	Noun	ˈristeilːæ
ristikko	Noun	ˈristikːo
ristiselkä	Noun	ˈristiˌselkæ
ristiä	Noun	ˈristiæ
ristiässä	Noun	ˈristiˌæsːæ
ritari	Noun	ˈritɑri
ritarillisuus	Noun	ˈritɑriˌlːisuːs
ritariperhonen	Noun	ˈritɑriˌperhonen
riuku	Noun	ˈriu̯ku
rivo	Adjective	ˈriʋo̞
rock	Noun	ɹʷɔk
rohjeta	Verb	ˈrohjetɑ
rohkaista	Verb	ˈrohkɑi̯stɑˣ
rohkea	Adjective	ˈrohkeɑ
rohkeasti	Adverb	ˈro̞xke̞ɑsti
rohkeus	Noun	ˈro̞xke̞us
rohmu	Noun	ˈrohmu
rohto	Noun	ˈro̞ht̪o̞
rojalismi	Noun	ˈro̞jɑˌlismi
rojalisti	Noun	ˈro̞jɑˌlisti
rojalistinen	Adjective	ˈro̞jɑˌlistine̞n
rojalti	Noun	ˈro̞jɑl̪t̪i
rokka	Noun	ˈrokːɑ
rokki	Noun	ˈrokːi
rokko	Noun	ˈro̞kːo̞
rokote	Noun	ˈrokote
rokottaa	Verb	ˈrokotːɑː(ʔ)
rokotus	Noun	ˈrokotus
romaani	Noun	ˈromɑːni
romahdella	Verb	ˈro̞mɑxde̞lːɑˣ
romahduttaa	Verb	ˈromɑxˌdutːɑː
romani	Noun	ˈromɑni
romantiikka	Noun	ˈromɑntiːkːɑ
romppu	Noun	ˈrompːu
rooli	Noun	ˈro̞ːli
roolipeli	Noun	ˈroːliˌpeli
roomalainen	Adjective	ˈroːmɑlɑinen
roska	Noun	ˈro̞skɑ
roskaa	Noun	ˈroskːɑː
roskaauto	Noun	ˈroskɑʔˌɑuto
roskapönttö	Noun	ˈroskɑˌpøntːø
rosmariini	Noun	ˈrosmɑriːni
rosolli	Noun	ˈrosolːi
rosvo	Noun	ˈrosʋo
rosvous	Noun	ˈrosʋous
rosé	Noun	ˈɹəʊ̯zeɪ̯
rosépippuri	Noun	ˈroseːˌpipːuri
rotevuus	Noun	ˈroteʋuːs
rotko	Noun	ˈrotko
rotta	Noun	ˈɹɔʰtːa
rottabaari	Noun	ˈrotːɑˌbɑːri
rotu	Noun	ˈrotu
roudarinteippi	Noun	ˈroudɑrinˌteipːi
rousku	Noun	ˈro̞usku
routa	Noun	ˈroutɑ
routaa	Verb	ˈroutɑː
rovasti	Noun	ˈroʋɑsti
ruhje	Noun	ˈruxjeˣ
ruhjoi	Verb	ˈruxjo̞i
ruis	Noun	rœy̯s
ruisku	Noun	ˈruisku
ruiskukka	Noun	ˈruisˌkukːɑ
rukki	Noun	ˈrukːi
rukoilijasirkka	Noun	ˈrukoilijɑˌsirkːɑ
rukoilla	Verb	ˈruko̞ilːɑˣ
rullalautailija	Noun	ˈrulːɑˌlɑutɑiˌlijɑ
ruma	Adjective	ˈrumɑ
rumasti	Adverb	ˈrumɑsti
rumpali	Noun	ˈrumpɑli
rumpu	Noun	ˈrumpu
runkkari	Noun	ˈruŋkːɑri
runo	Noun	ˈruno̞
runous	Noun	ˈruno̞us
runsas	Adjective	ˈrunsɑs
ruoho	Noun	ˈruoho
ruokahalu	Noun	ˈruokɑˌhɑlu
ruokahaluttomuus	Noun	ˈruokɑˌxɑlutːomuːs
ruokalaji	Noun	ˈruɔkɑˌlɑji
ruokasieni	Noun	ˈruokɑˌsieni
ruokintapaikka	Noun	ˈruɔkintɑˌpɑikːɑ
ruokkia	Noun	ˈruokːi.ɑ
ruori	Noun	ˈruɔri
ruoska	Noun	ˈruoskɑ
ruoste	Noun	ˈruɔste̞ˣ
ruotsalainen	Noun	ˈruo̯tsɑlɑi̯nen
ruotsalainenoo	Noun	ˈruo̯tsɑlɑi̯nen oː
ruotsalaistaa	Verb	ˈruotsɑˌlɑistɑːˣ
rupsahtaa	Verb	ˈrupsɑxtɑː
rusakko	Noun	ˈrusɑkːo
rusina	Noun	ˈrusinɑ
ruska	Noun	ˈruskɑ
ruskohiili	Noun	ˈrusko̞ˌhiːli
russakka	Noun	ˈrusːɑkːɑ
rustokala	Noun	ˈrustoˌkɑlɑ
rustottua	Verb	ˈrusto̞t̪ːuɑˣ
rustynail	Noun	ˈrɑsti ˈneil
rutata	Verb	ˈrutɑtɑ(ʔ)
ruumiinkieli	Noun	ˈruːmiːŋˌkie̞li
ruuna	Noun	ˈruːnɑ
ruusu	Noun	ˈruːsu
ruutana	Noun	ˈruːtɑnɑ
ryhtyä	Verb	ˈryçtyæˣ
rykiä	Verb	ˈryki.æˣ
ryminä	Noun	ˈryminæ
rynnäs	Noun	ˈrynːæs
rynnätä	Verb	ˈrynːæt̪æ(ʔ)
ryppy	Noun	rypːy
rypsi	Noun	ˈrypsi
rypäle	Noun	ˈrypæle(ʔ)
rypälesokeri	Noun	ˈrypælesˌsokeri
ryssiä	Noun	ˈrysːiæ
rytmihäiriö	Noun	ˈryt̪miˌcæiriø̞
ryysyinen	Adjective	ˈryːsyˌinen
ryysyläinen	Noun	ˈryːsyˌlæinen
ryömiä	Verb	ˈryø̞mi.æ
ryöstää	Verb	ˈryøstæː(ʔ)
ryöstö	Noun	ˈryøstø
ryöväri	Noun	ˈryøværi
ryövätä	Verb	ˈryøvætæ
ryöväys	Noun	ˈryøʋæys
räi	Verb	ˈræiˣ
räjähde	Noun	ˈræjæçde̞ˣ
räjähdellä	Verb	ˈræjæçde̞lːæˣ
räkiä	Verb	ˈræki.æˣ
räkki	Noun	ˈrækːi
räksytetään	Verb	ˈræksyt̪et̪æːn
räkärätti	Noun	ˈræk̟æˌræt̪ːi̞
räme	Noun	ˈræme̞ˣ
rämpiä	Verb	ˈræmpiæˣ
rämä	Adjective	ˈræmæ
räpylä	Noun	ˈræpylæ
räpyläsara	Noun	ˈræpylæˌsɑrɑ
rättipää	Noun	ˈrætːiˌpæː
räyhähenki	Noun	ˈræyɦæˌheŋki
räystäs	Noun	ˈræystæs
räystäspääsky	Noun	ˈræystæsˌpæːsky
rääkyä	Verb	ˈræːky.æˣ
rääppiäiset	Noun	ˈræːpːiæise̞t̪
rääy	Verb	ˈræːy
rönsyleinikki	Noun	ˈrønsyˌleinikːi
röntgensäde	Noun	ˈrø̞n̪t̪ɡe̞nˌsæde̞ˣ
röyhtäistä	Verb	ˈrøyctæistæ
röyhy	Noun	ˈrøyɦy
saha	Noun	ˈsɑhɑ
sahaava	Verb	ˈsɑɦɑːʋɑ
sahrami	Noun	ˈsɑxrɑmi
sahti	Noun	ˈsɑxti
sai	Noun	saɪ
sairaalan	Noun	ˈsɑirɑːlɑn
sairastaa	Verb	ˈsɑirɑstɑː(ʔ)
sakaali	Noun	ˈʃɑkɑːli
saketti	Noun	ˈsɑketːi
sakki	Noun	ˈsɑkːi
sakko	Noun	ˈsɑkːo
saksalainen	Noun	ˈsɑksɑˌlɑinen
saksanpähkinä	Noun	ˈsɑksɑnˌpæckinæ
saku	Noun	ˈsɑku
salaa	Adverb	ˈsɑlɑː
salaatti	Noun	ˈsɑlɑːtːi
salakka	Noun	ˈsɑlɑkːɑ
salakuuntelu	Noun	ˈsɑlɑˌkuːntelu
salakähmäisyys	Noun	ˈsɑlɑˌkæçmæisyːs
salaliitto	Noun	ˈsɑlɑˌliːtːo
salama	Noun	ˈsɑlɑmɑ
salamannopea	Adjective	ˈsɑlɑmɑnˌnopeɑ
salami	Noun	sɘˈlɑːmɪ
salaseura	Noun	ˈsɑlɑˌse̞urɑ
salaus	Noun	ˈsɑlɑus
salava	Verb	ˈsɑlɑʋɑ
saldo	Noun	ˈsɑldo
sali	Verb	ˈsali
salibandy	Noun	ˈsɑliˌbændi
salko	Noun	ˈsɑlko
salli	Verb	ˈsɑlːi
sallimus	Noun	ˈsɑlːimus
salmeksi	Noun	ˈsɑlme̞ksi
salonki	Noun	ˈsɑloŋki
salpa	Noun	ˈsɑlpɑ
salpaaja	Noun	ˈsɑlpɑːjɑ
salva	Verb	ˈsalva
salvata	Verb	ˈsɑlvɑtɑ
salvia	Noun	ˈsælvɪə
samaani	Noun	ˈʃɑmɑːni
samaistua	Verb	ˈsɑmɑistuɑˣ
samanlainen	Adjective	ˈsɑmɑnˌlːɑinen
samastua	Verb	ˈsɑmɑstuɑˣ
samea	Adjective	ˈsɑmeɑ
samettikukka	Noun	ˈsametːiˌkukːɑ
sammakko	Noun	ˈsɑmːɑkːo
sammal	Noun	ˈsɑmːɑl
sammas	Noun	ˈsɑmːɑs
sammua	Verb	ˈsɑmːuɑˣ
sammuttaa	Verb	ˈsɑmːut̪ːɑːˣ
samoanlentäväkoira	Noun	ˈsɑmo̞ɑn̪ˌle̞n̪t̪æʋæˌko̞irɑ
samoilu	Noun	ˈsɑmoilu
sampi	Noun	ˈsɑmpi
sampo	Noun	ˈsɑmpo
sampoo	Noun	ˈsɑmpːoː
sane	Adjective	seɪn
saneen	Noun	ˈsɑne̞ːn
saneet	Noun	ˈsɑne̞ːt̪
sangat	Noun	ˈsɑŋːɑt
sangen	Noun	ˈsɑŋːe̞n
sangon	Noun	ˈsɑŋːo̞n
sankari	Noun	ˈsɑŋkɑri
sankaritar	Noun	ˈsɑŋkɑritɑr
sanko	Noun	ˈsɑŋko
sanoa	Verb	ˈsɑnoɑˣ
sanoi	Verb	ˈsɑnoi
sanotaan	Verb	ˈsɑnotɑːn
sanottaneen	Verb	ˈsɑnotːɑneːn
santa	Noun	ˈsan.tə
santaa	Noun	ˈsɑntɑː
santelipuu	Noun	ˈsɑn̪t̪e̞liˌpuː
saparo	Noun	ˈsɑpɑro
sapeli	Noun	ˈsɑpeli
sappi	Noun	ˈsɑpːi
sappikivi	Noun	ˈsɑpːiˌkivi
sapuska	Noun	ˈsɑpuskɑ
sara	Noun	saˈra
sarake	Noun	ˈsɑrɑke(ʔ)
sarana	Noun	ˈsɑrɑnɑ
sarastaa	Verb	ˈsɑrɑstɑːˣ
sarja	Noun	ˈsɑrjɑ
sarka	Noun	ˈsɑrkɑ
sarveiskalvo	Noun	ˈsɑrveisˌkɑlvo
sarvijaakko	Noun	ˈsɑrʋiˌjɑːkːo
sarvikuonokas	Noun	ˈsɑrʋiˌkuonokɑs
sata	Adjective	ˈsata
sataa	Verb	ˈsɑt̪ɑː(ʔ)
satama	Noun	ˈsɑtɑmɑ
satamaan	Noun	ˈsɑt̪ɑmɑːn
sateenkaari	Noun	ˈsɑteːnˌkɑːri
sateenkaarikala	Noun	ˈsɑteːŋˌkɑːriˌkɑlɑ
sateettomasti	Adverb	ˈsɑteːtːoˌmɑsti
sato	Noun	ˈsɑt̪o
satoitaipaistoi	Adverb	ˈsɑtoi ˈtɑi ˈpɑistoi
sattua	Verb	ˈsɑtːuɑ(ʔ)
sattumanvaraisesti	Adverb	ˈsɑtːumɑnˌʋɑrɑisesti
sattuneesta	Verb	ˈsɑtːuneːstɑ
sattuneestasyystä	Adverb	ˈsɑtːuneːstɑ ˈsyːstæ
sattunut	Verb	ˈsɑtːunut
satulalaukku	Noun	ˈsɑtulɑˌlɑukːu
satunnainen	Adjective	ˈsɑtunːɑinen
satunnaisotos	Noun	ˈsɑtunːɑisˌotos
satuttaa	Verb	sɑtutːɑː(ʔ)
saukko	Noun	ˈsɑukːo
saumuri	Noun	ˈsɑumuri
sauna	Noun	ˈsɔː.nə
sauva	Noun	ˈsɑuʋɑ
sauvasekoitin	Noun	ˈsɑu̯ʋɑˌsekoi̯tin
savi	Noun	ˈsa.vi
savinen	Adjective	ˈsɑʋine̞n
savu	Verb	ˈsɑʋu
savuinen	Adjective	ˈsɑʋuinen
savuta	Verb	ˈsɑʋutɑˣ
schapendoes	Noun	ˈshɑːpendos
scifi	Noun	ˈskifi
se	Noun	sə
see	Verb	siː
seepra	Noun	ˈseːprɑ
sei	Noun	ˈsei̯
seihin	Noun	ˈseihin
seikkailla	Verb	ˈse̞ikːɑilːɑˣ
seikkailu	Noun	ˈseikːɑilu
sein	Noun	sɛi̯n
seinä	Noun	ˈse̞inæ
seinämä	Noun	ˈse̞inæmæ
seipi	Noun	ˈseipi
seis	Noun	ˈsei̯s
seiska	Numeral	ˈseiskɑ
seisoa	Verb	ˈsei̯soɑˣ
seistä	Verb	ˈseistæ(ʔ)
seiti	Noun	ˈseiti
seitsenruototokko	Noun	ˈseitsenˌruotoˌtokːo
seiväshyppy	Noun	ˈse̞iʋæsˌcypːy
sekavuus	Noun	ˈsekɑʋuːs
sekoilla	Verb	ˈse̞ko̞ilːɑˣ
sekoittaa	Verb	ˈsekoitːɑː(ʔ)
sekoittua	Verb	ˈsekoitːuɑ(ʔ)
sekoitus	Noun	ˈse̞ko̞it̪us
sekovarsi	Noun	ˈsekoˌʋɑrsi
seksikäs	Adjective	ˈseksikæs
seksismi	Noun	ˈse̞ksismi
seksisti	Noun	ˈse̞ksisti
sekstantti	Noun	ˈsekstɑntːi
seksuaalirikollinen	Noun	ˈseksuɑːliˌrikolːinen
seksuaalivähemmistö	Noun	ˈseksuɑːliˌʋæɦemːistø
sektio	Noun	ˈse̞kt̪io̞
sekulaarinen	Adjective	ˈsekulɑːrinen
sekunti	Noun	ˈsekunti
sekuntikello	Noun	ˈsekuntiˌkelːo
selaa	Verb	ˈselɑː
selain	Noun	ˈse̞lɑin
selitellä	Verb	ˈselitelːæ(ʔ)
selittää	Verb	ˈse̞lit̪ːæː(ʔ)
selko	Noun	ˈse̞lko̞
selkä	Noun	ˈse̞lkæ
selkäkipu	Noun	ˈselkæˌkipu
selkäranka	Noun	ˈselkæˌrɑŋkɑ
selkäydin	Noun	ˈselkæˌydin
selkäänpuukottaja	Noun	ˈselkæːmˌpuːkotːɑjɑ
sellainen	Adjective	ˈselːɑinen
selliä	Noun	ˈselːiæ
selostaa	Verb	ˈse̞lo̞stɑːˣ
selostaja	Noun	ˈse̞lo̞stɑjɑ
selvä	Adjective	ˈselvæ
selänrapsutin	Noun	ˈselænˌrɑpsutin
sen	Noun	sɛn
sentrifugi	Noun	ˈsentrifuɡi
senttaali	Noun	ˈsent.tɑː.li
sentti	Noun	ˈse̞n̪t̪ːi
seos	Noun	ˈse̞.o̞s
sepeli	Noun	ˈsepeli
sepelvaltimo	Noun	ˈsepelˌʋɑltimo
sepivä	Adjective	ˈsepiʋæ
seppä	Noun	ˈse̞pːæ
seteli	Noun	ˈse̞t̪e̞li
setä	Noun	ˈsetæ
setäpuoli	Noun	ˈsetæˌpuɔli
seulonta	Noun	ˈse̞ulo̞n̪t̪ɑ
seuraat	Verb	ˈseurɑːt
seuraava	Adjective	ˈseurɑːʋɑ
seuraavasti	Adverb	ˈse̞uraːˌʋɑstiˣ
seurannaisvaikutus	Noun	ˈseurɑnːɑisˌʋɑikutus
seurata	Verb	ˈseu̯rɑtɑˣ
seurustelu	Noun	ˈseurusˌtelu
seurusteluhuone	Noun	ˈseurusˌteluˌhuɔneˣ
seutu	Noun	ˈseutu
shaali	Noun	ˈʃɑːli
shaketti	Noun	ˈʃɑketːi
shakki	Noun	ˈʃɑkːi
shamaani	Noun	ˈʃɑmɑːni
shamanismi	Noun	ˈʃɑmɑnismi
shampoo	Noun	ʃæmˈpu
sheikki	Noun	ˈʃe͡ikːi
shekki	Noun	ˈʃekːi
shetlanninponi	Noun	ˈʃe̞t̪l̪ɑnːinˌpo̞ni
shikaani	Noun	ˈʃikɑːni
shop	Noun	ʃɒp
shoppailla	Verb	ˈʃo̞pːɑilːɑˣ
shoppi	Noun	ˈʃopːi
shuttlebussi	Noun	ˈʃɑtːelˌbusːi
siankärsämö	Noun	ˈsiɑnˌkærsæmø
sianliha	Noun	ˈsiɑnˌlihɑ
sianmarja	Noun	ˈsiɑnˌmɑrjɑ
sianpuolukka	Noun	ˈsiɑnˌpuolukːɑ
side	Noun	saɪd
sideharso	Noun	ˈsideˌxːɑrso
sidekalvo	Noun	ˈsideˌkːɑlʋo
sidekalvontulehdus	Noun	ˈsideˌkːɑlʋonˌtulehdus
sidekudos	Noun	ˈsideˌkːudos
sielunvaellus	Noun	ˈsielunˌvɑelːus
siemensyöksy	Noun	ˈsiemenˌsyøksy
sieni	Noun	ˈsieni
sienijuuri	Noun	ˈsieniˌjuːri
sienikeitto	Noun	ˈsieniˌkeitːo
sienirihmasto	Noun	ˈsieniˌrihmɑsto
siepata	Verb	ˈsiepɑtɑ(ʔ)
sieppaaja	Noun	ˈsiepːɑːjɑ
sieppo	Noun	ˈsiepːo
sievä	Adjective	ˈsieʋæ
sigma	Noun	ˈsɪɡmə
signaali	Noun	ˈsiŋnɑːli
signaalinkäsittely	Noun	ˈsiŋnɑːlinˌkæsitːely
sihti	Noun	ˈsiç̞t̪i
siika	Noun	ˈsiːkɑ
siima	Noun	ˈsiːmɑ
siippa	Noun	ˈsiːpːɑ
siira	Noun	ˈsiːrɑ
siirappi	Noun	ˈsiːrɑpːi
siirtyäautuaammillemetsästysmaille	Verb	ˈsiːrtyæ ˈɑutuɑːmilːe ˈmetsæstysˌmɑilːeˣ
siirtyätuonpuoleiseen	Verb	ˈsiːrtyæˣ ˈtːuomˌpuoleiseːn
siis	Adverb	ˈsiːs
siisti	Adjective	ˈsiːsti
siitake	Noun	ˈsiːt̪ɑke̞(ˣ)
siitakesieni	Noun	ˈsiːtɑkeˌsieni
siitti	Verb	ˈsiːtːi
siittiö	Noun	ˈsiːtːiø
siittää	Verb	ˈsiːtːæː(ʔ)
siitä	Pronoun	ˈsiːtæ
siiveke	Noun	ˈsiːveke(ʔ)
siivous	Noun	ˈsiːʋous
sija	Noun	ˈsijɑ
sijaisvanhempi	Noun	ˈsijɑisˌʋɑnhe̞mpi
sijamuoto	Noun	ˈsijɑˌmuɔto
sijapääte	Noun	ˈsijɑˌpæːt̪e̞ˣ
sika	Noun	ˈsikɑ
sikari	Noun	ˈsikɑri
sikermä	Noun	ˈsikermæ
sikiö	Noun	ˈsikiø
sikotauti	Noun	ˈsikoˌtɑuti
siksi	Pronoun	ˈsiksi
sikuri	Noun	ˈsikuri
silakkalaatikko	Noun	ˈsilɑkːɑˌlɑːtikːo
silhuetti	Noun	ˈsilhuetːi
silikoni	Noun	ˈsilikoni
silityslauta	Noun	ˈsilitysˌlɑutɑ
silitysrauta	Noun	ˈsilitysˌrɑutɑ
silkki	Noun	ˈsilkːi
silkkiterrieri	Noun	ˈsilkːiˌterːieri
silkkiuikku	Noun	ˈsilkːiˌuikːu
silla	Noun	silːɑ
silminnäkijä	Noun	ˈsilminˌnækijæ
silmä	Noun	ˈsilmæ
silmäkuoppa	Noun	ˈsilmæˌkuopːɑ
silmänkääntäjä	Noun	ˈsilmænˌkæːntæjæ
sima	Noun	ˈsimɑ
simapanimo	Noun	ˈsimɑˌpɑnimo̞
simoninhyppymyyrä	Noun	ˈsimoninˌhypːyˌmyːræ
simpanssi	Noun	ˈsimpɑnsːi
simpukka	Noun	ˈsimpukːɑ
simputtaa	Verb	ˈsimput̪ːɑː
simputus	Noun	ˈsimput̪us
simulaatio	Noun	ˈsimulɑːtio
simulaattori	Noun	ˈsimulɑːtːori
simultaanitulkki	Noun	ˈsimultɑːniˌtulkːi
sinappi	Noun	ˈsinɑpːi
sinfonia	Noun	ˈsiɱfːo̞n̪iɑ
single	Adjective	ˈsɪŋɡl
sinililja	Noun	ˈsinililjɑ
sinirinta	Noun	ˈsiniˌrintɑ
sinivalas	Noun	ˈsiniˌvɑlɑs
sinivuokko	Noun	ˈsiniˌʋuɔkːo̞
sinkkivälke	Noun	ˈsiŋkːiˌʋælke(ʔ)
sinkku	Noun	ˈsiŋkːu
sinkkuus	Noun	ˈsiŋkːuːs
sintrata	Verb	ˈsintrata
sinua	Pronoun	ˈsinuɑ
sinuksi	Pronoun	ˈsinuksi
sinulla	Pronoun	ˈsinulːɑ
sinulle	Pronoun	ˈsinulːe(ʔ)
sinulta	Pronoun	ˈsinultɑ
sinun	Pronoun	ˈsinun
sinuna	Pronoun	ˈsinunɑ
sinussa	Pronoun	ˈsinusːɑ
sinusta	Pronoun	ˈsinustɑ
sinut	Pronoun	ˈsinut
sinutella	Verb	ˈsinutelːɑ(ʔ)
sinutta	Pronoun	ˈsinutːɑ
sinuun	Pronoun	ˈsinuːn
sinä	Pronoun	ˈsinæ
sinänsä	Adverb	ˈsinænsæ
sioux	Noun	ˈsiou̯ks
siperianhusky	Noun	ˈsiperiɑnˌhɑski
siperianjokilohi	Noun	ˈsipe̞riɑnˌjo̞kilo̞hi
sipuli	Noun	ˈsipuli
sirittäjä	Noun	ˈsiritːæjæ
sirkkalehti	Noun	ˈsirkːɑˌlehti
sirkus	Noun	ˈsirkus
sirkustirehtööri	Noun	ˈsirkusˌt̪ire̞ht̪ø̞ːri
sironta	Noun	ˈsirontɑ
sirota	Verb	ˈsiro̞t̪ɑˣ
sirppi	Noun	ˈsirpːi
sisar	Noun	ˈsisɑr
sisaruus	Noun	ˈsisɑruːs
sisimmäinen	Adjective	ˈsisimːæinen
sisu	Noun	ˈsisu
sisukas	Adjective	ˈsisukɑs
sisäinen	Adjective	ˈsisæinen
sisällys	Noun	ˈsisælːys
sisällysluettelo	Noun	ˈsisælːysˌlue̞t̪ːe̞lo̞
sisältää	Verb	ˈsisæltæː(ʔ)
sisältö	Noun	ˈsisæltø
sisämeri	Noun	ˈsisæˌmeri
sisäministeri	Noun	ˈsisæˌministe̞ri
sisäydin	Noun	ˈsisæˌydin
siten	Adverb	ˈsiten
sitoi	Verb	ˈsitoi
sitruunaperhonen	Noun	ˈsitruːnɑˌperhonen
sitten	Verb	ˈsitːen
siviili	Noun	ˈsiʋiːli
siviilipalvelus	Noun	ˈsiʋiːliˌpɑlʋelus
siviilipalvelusmies	Noun	ˈsiʋiːliˌpɑlʋe̞lusˌmie̞s
siviilisääty	Noun	ˈsiʋiːliˌsæːty
sivu	Noun	ˈsiʋu
sivuosa	Noun	ˈsiʋuˌosɑ
sivuvaikutus	Noun	ˈsiʋuˌʋɑikutus
skaala	Noun	ˈskɑːlɑ
skannata	Verb	skɑnːɑtɑˣ
skini	Noun	ˈskini
skitsofrenia	Noun	ˈskit̪so̞fre̞niɑ
skoude	Noun	ˈsko̞ude̞
skumppa	Noun	ˈskumpːɑ
skypettää	Verb	ˈskypetːæːˣ
slapstick	Noun	ˈslæpstik
slummi	Noun	ˈslumːi
slush	Noun	slʌʃ
smokki	Noun	ˈsmokːi
snautseri	Noun	ˈsnɑut̪se̞ri
socinolainen	Noun	 ˈso̞sino̞lɑine̞n
sodi	Noun	ˈso̞diˣ
softice	Noun	ˈsoftˌɑi̯s
sohia	Verb	ˈsoɦiɑˣ
sohjoinen	Adjective	ˈso̞xjo̞ine̞n
soi	Noun	ˈsoi
soida	Verb	ˈso̞idɑ(ʔ)
soidin	Noun	ˈsoidin
soijamaito	Noun	ˈso̞ijɑˌmɑit̪o̞
soijarouhe	Noun	ˈso̞ijːɑˌro̞uɦe̞ˣ
soikea	Adjective	ˈsoi̯keɑ
soin	Noun	ˈsoin
sointuoppi	Noun	ˈsointuˌopːi
soisi	Verb	ˈso̞isi
soitin	Noun	ˈsoitin
soittaa	Verb	ˈsoi̯tːɑːˣ
soittolista	Noun	ˈsoit̪ːoˌlistɑ
soittoääni	Noun	ˈsoitːoˌæːni
sokeri	Noun	ˈsokeri
sokerihumala	Noun	ˈsokeriˌhumɑlɑ
sokerikakku	Noun	ˈso̞ke̞riˌkɑkːu
sokeripala	Noun	ˈsokeriˌpɑlɑ
sokeritauti	Noun	ˈsokeriˌtɑuti
sokeus	Noun	ˈso̞ke̞us
sokka	Noun	ˈsokːɑ
sokkopaarma	Noun	ˈsokːoˌpɑːrmɑ
solttu	Noun	ˈsol̪t̪ːu
soma	Noun	ˈsoʊmə
some	Pronoun	sʌm
somistaa	Verb	ˈso̞mistɑːˣ
sondi	Verb	ˈsondi
sonetti	Noun	ˈsonetːi
sontikka	Noun	ˈson̪t̪ikːɑ
soopelinnahka	Noun	ˈsoːpeliˌnːɑħkɑ
sopia	Verb	ˈso̞pi.ɑˣ
sopimus	Noun	ˈsopimus
sopiva	Adjective	ˈso̞piʋɑ
soppi	Noun	ˈso̞pːi
sopu	Noun	ˈsopu
sopuli	Noun	ˈsopuli
sorar	Noun	ˈso̞rɑ ˈær
sorkkarauta	Noun	ˈsorkːɑˌrɑutɑ
sormenjälkitutkimus	Noun	ˈsormenˌjælkiˌtutkimus
sormenkynsi	Noun	ˈsormenˌkynsi
sormi	Noun	ˈsormi
sormus	Noun	ˈsormus
sormustin	Noun	ˈsormustin
sorrettu	Adjective	ˈsorːetːu
sorsa	Noun	ˈso̞rsɑ
sortaa	Verb	ˈsortɑː(ʔ)
sortuu	Verb	ˈso̞rtuː
sortuva	Verb	ˈso̞rtuʋɑ
sorva	Noun	ˈsorʋɑ
sorvata	Verb	ˈso̞rʋɑt̪ɑˣ
sosiaaliturva	Noun	ˈsosiɑːliˌturʋɑ
soti	Verb	ˈso̞t̪i
sotia	Verb	ˈso̞t̪i.ɑˣ
sotilastukikohta	Noun	ˈso̞t̪ilɑsˌt̪ukiˌko̞xt̪ɑ
sotkea	Verb	ˈsotkeɑ(ʔ)
sottiisi	Noun	ˈsotːiːsi
sotu	Noun	ˈsotu
soudella	Verb	ˈso̞ude̞lːɑˣ
soutaa	Verb	ˈso̞ut̪ɑːˣ
soutaajahuovata	Verb	ˈsoutɑːˈ jːɑ ˈhuovɑtɑ(ʔ)
soveltaa	Verb	ˈso̞ʋe̞ltɑːˣ
sovi	Verb	ˈsoʋiˣ
sovitin	Noun	ˈso̞ʋit̪in
sovitteleva	Verb	ˈso̞ʋit̪t̪e̞le̞ʋɑ
sovittelevasti	Adverb	ˈso̞ʋit̪t̪e̞le̞ʋɑst̪i
sovitus	Noun	ˈsoʋitus
speedway	Noun	ˈspiːdweɪ
spesies	Noun	ˈspe̞ːsie̞s
spitaali	Noun	ˈspitɑːli
spray	Noun	spɹeɪ
sprayhood	Noun	ˈspre̞iˌɦuːd
spraymaalata	Verb	ˈspre̞imɑːlɑtɑ
spraymaali	Noun	ˈspre̞imɑːli
spraytölkki	Noun	ˈspre̞iˌt̪ølkːi
staalo	Noun	ˈstɑːlo
standardi	Noun	ˈstɑndɑrdi
stemma	Noun	ˈstemːɑ
stephensaartensammakko	Noun	ˈste̞fe̞nˌsɑːrte̞nˌsɑmːɑkːo̞
stereotypia	Noun	ˈste̞re̞o̞ˌt̪ypiɑ
sterletti	Noun	ˈsterletːi
stipendi	Noun	ˈstipendi
stressi	Noun	ˈstresːi
stretch	Adjective	ˈst̪re̞t̪ʃ
striptease	Noun	ˈst̪ript̪iːs
strutsi	Noun	ˈstrut̪si
strösseli	Noun	ˈstrøsːeli
stökiometria	Noun	ˈstøkioˌme̞t̪riɑ
subkutaaninen	Adjective	ˈsubˌkutaːninen
subwoofer	Noun	ˈsubʋuːfːeri
sudenkorento	Noun	ˈsude̞nˌko̞re̞n̪t̪o̞
sudi	Verb	ˈsudiˣ
suhdannetyöttömyys	Noun	ˈsuɦdɑnːeˌtːyøtːømyːs
suhdeluku	Noun	ˈsuxʷdeˌlːuku
suhteellinen	Adjective	ˈsuxteːlːinen
suikea	Adjective	ˈsuikeɑ
sujua	Verb	ˈsujuɑˣ
suka	Noun	ˈs̪uka
sukellusvene	Noun	ˈsukelːusˌʋene(ʔ)
sukia	Noun	ˈsuki.ɑ
sukka	Noun	ˈsukːɑ
sukkahousut	Noun	ˈsukːɑˌxo̞usut̪
suklaa	Noun	ˈsuklɑː
suklaata	Noun	ˈsuklɑːtɑ
suku	Noun	ˈsuku
sukua	Noun	ˈsːukuɑ
sukuelin	Noun	ˈsukuˌe̞lin
sukupuolentutkimus	Noun	ˈsukuˌpuɔlenˌtutkimus
sukupuoli	Noun	ˈsukuˌpuoli
sukupuoliidentiteetti	Noun	ˈsukupuoli(ʔ)ˌidentiteːtːi
sukupuolivähemmistö	Noun	ˈsukuˌpuoliˌʋæɦemːistø
sukusolu	Noun	ˈsukuˌsolu
sukututkimus	Noun	ˈsukuˌtutkimus
sula	Noun	ˈsulɑ
sulaa	Adjective	ˈsulɑː
sulattaa	Verb	ˈsulɑtːɑː(ʔ)
sulje	Noun	ˈsuljeˣ
sulkapallo	Noun	ˈsulkɑˌpɑlːo
sulkea	Verb	ˈsulkeɑ(ʔ)
suma	Noun	ˈsu.mə
sumuinen	Noun	ˈsumuine̞n
sunnuntai	Noun	ˈsunːun̪t̪ɑi
suntti	Noun	ˈsuntːi
suo	Verb	suo
suoda	Verb	ˈsuodɑ(ʔ)
suodattaa	Verb	ˈsuɔdɑtːɑːˣ
suojaa	Noun	ˈsuojːɑː
suojasatama	Noun	ˈsuɔjɑˌsɑtɑmɑ
suojasää	Noun	ˈsuojɑˌsæː
suojata	Verb	ˈsuojɑtɑ(ʔ)
suojavarustus	Noun	ˈsuɔjɑˌʋɑrustus
suojelija	Noun	ˈsuojelijɑ
suola	Noun	ˈsuɔlɑ
suoli	Noun	ˈsuɔli
suolla	Noun	ˈsuolːɑ
suoltaa	Verb	ˈsuoltɑː
suomalainen	Adjective	ˈsuo̯mɑlɑi̯nen
suomentaa	Verb	ˈsuo̯mentɑːˣ
suomi	Noun	ˈsuomi
suopa	Noun	ˈsuopɑ
suopayrtti	Noun	ˈsuopɑˌyrtːi
suora	Adjective	ˈsuo̯rɑ
suoruus	Noun	ˈsuɔruːs
suosittu	Adjective	ˈsuositːu
suostutella	Verb	ˈsuɔstuˌtelːɑˣ
suotava	Adjective	ˈsuotɑvɑ
supi	Noun	ˈsupi
suppilo	Noun	ˈsupːilo
suppupaarma	Noun	ˈsupːuˌpɑːrmɑ
surjektio	Noun	ˈsurjektio
surkastua	Verb	ˈsurkɑstuɑˣ
surmata	Noun	ˈsurmɑtɑ(ʔ)
surra	Noun	ˈsurːɑˣ
suru	Noun	ˈsuru
surut	Noun	sˈurut̪
susi	Noun	ˈsusi
sutenööri	Noun	ˈsutenøːri
suti	Noun	ˈsut̪i
sutia	Verb	ˈsut̪i.ɑˣ
suu	Noun	ˈsuː
suudella	Verb	ˈsuːde̞lːɑˣ
suudellen	Verb	ˈsuːdelːen
suudelma	Noun	ˈsuːdelmɑ
suukapula	Noun	ˈsuːˌkɑpulɑ
suukki	Noun	ˈsuːkːi
suukku	Noun	ˈsuːkːu
suulas	Adjective	ˈsuːlɑs
suulla	Noun	ˈsuːlːɑ
suunnitella	Verb	ˈsuːnːitelːɑˣ
suunnittelu	Noun	ˈsuːnːitːelu
suunta	Noun	ˈsuːntɑ
suuntia	Verb	ˈsuːn̪t̪i.ɑˣ
suupaltti	Noun	ˈsuːˌpɑltːi
suura	Noun	ˈsuːrɑ
suure	Noun	ˈsuːreˣ
suurentaa	Verb	ˈsuurentaa
suuri	Adjective	ˈsuːri
suurjännite	Noun	suːrjænːite
suurmanner	Noun	ˈsuːrˌmɑnːer
suurtaajuus	Noun	suːrtɑːjuːs
suuruudenhullu	Noun	ˈsuːruːde̞nˌxulːu
suuruudenhulluus	Noun	ˈsuːruːdenˌɦulːuːs
suuruus	Noun	ˈsuːruːs
suutari	Noun	ˈsuːtɑri
suvaita	Verb	ˈsuʋɑitɑˣ
sviitti	Noun	ˈsviːtːi
sydneyläinen	Noun	ˈsidnilæine̞n
sydämentykytys	Noun	ˈsydæmːenˌtykytys
sydämet	Noun	ˈsydæmːe̞t̪
sydämetön	Adjective	ˈsydæmːe̞t̪ø̞n
sydän	Noun	ˈsydæn
sydänhermovika	Noun	ˈsydænˌhermoˌʋikɑ
sydänkäpy	Noun	ˈsydænˌkæpy
sydänyö	Noun	ˈsydænˌyø̯
syke	Noun	ˈsyke(ʔ)
sykkiä	Verb	ˈsykːi.æˣ
syksy	Noun	ˈsyksy
syksymmällä	Adverb	ˈsyksymːælːæ
syksympänä	Adverb	ˈsyksympænæ
syleillä	Noun	ˈsyle̞ilːæ
syli	Noun	ˈsyli
syljeskellä	Verb	ˈsyljeskelːæ(ʔ)
sylkikuoriainen	Noun	ˈsylkiˌkuɔriɑine̞n
sylkirauhanen	Noun	ˈsylkiˌrɑuɦɑnen
sympaattinen	Adjective	ˈsympɑːt̪ːine̞n
synninpäästö	Noun	ˈsynːimˌpæːstø
synnyttää	Verb	ˈsynːytːæː(ʔ)
synonyymi	Noun	ˈsynonyːmi
syntyvyys	Noun	ˈsyn̪tyʋyːs
syntyä	Noun	ˈsyntyæ
syrjintä	Noun	ˈsyrjintæ
syrjiä	Noun	ˈsyrjiæ
sysi	Noun	ˈsysi
sysimusta	Adjective	ˈsysiˌmustɑ
syttyisi	Verb	ˈsyt̪ːyisi
syttyä	Verb	ˈsyt̪ːyæˣ
sytyttäminen	Noun	ˈsytytːæˌminen
syvyys	Noun	ˈsyʋyːs
syvä	Adjective	ˈsyʋæ
syväkurkku	Noun	ˈsyʋæˌkurkːu
syvämeri	Noun	ˈsyʋæmeri
syy	Noun	syː
syyllistyä	Verb	ˈsyːlːistyæ(ʔ)
syyllistää	Verb	ˈsyːlːistæː(ʔ)
syyntakeeton	Adjective	ˈsyːnˌt̪ɑke̞ːt̪o̞n
syyspäiväntasaus	Noun	ˈsyːsˌpæivæntɑsɑus
syystä	Noun	ˈsyːstæ
syyte	Noun	ˈsyːte(ʔ)
syytinki	Noun	ˈsyːtiŋki
syyttää	Verb	ˈsyːtːæː(ʔ)
syytös	Noun	ˈsyːtøs
syö	Verb	syøː
syödä	Verb	ˈsyø̯dæˣ
syöksykierre	Noun	ˈsyøksyˌkierːeˣ
syöksykäämme	Verb	ˈsyøksyˌkæːmːe
syöksyä	Noun	ˈsyøksyæ
syömäpuikko	Noun	ˈsyømæˌpuikːo
syön	Noun	ˈsyøn
syöpä	Noun	ˈsyø̞pæ
syöstä	Verb	ˈsyøstæ(ʔ)
syöstään	Verb	ˈsyøstæːn
syöttäjä	Noun	ˈsyøtːæjæ
syöttää	Verb	ˈsyøtːæː(ʔ)
syöttääpajunköyttä	Verb	ˈsyø̯tːæː pɑjuŋkøy̯tːæ
sä	Pronoun	ˈsæ
säde	Noun	ˈsæde̞ˣ
säe	Noun	ˈsæe(ʔ)
sähkö	Noun	ˈsæhkø̞
sähkökeskus	Noun	ˈsæçkøˌke̞skus
sähkömies	Noun	ˈsæckø̞ˌmie̞s
sähköpostitse	Adverb	ˈsæhkøˌpo̞st̪it̪se̞ˣ
säie	Noun	ˈsæie(ʔ)
säieteoria	Noun	ˈsæieˌtːeoriɑ
säikkyä	Adjective	ˈsæikːyæ
säikähtää	Verb	ˈsæikæhtæː(ʔ)
säilyttäneen	Verb	ˈsæilytːæneːn
säilyttää	Verb	ˈsæilytːæː(ʔ)
säilyä	Verb	ˈsæilyæ(ʔ)
säilä	Noun	ˈsæilæ
säilön	Noun	ˈsæiløn
säilöntä	Noun	ˈsæilø̞n̪t̪æ
säilöntäaine	Noun	ˈsæilø̞n̪t̪æˌɑine̞ˣ
säilöttäneen	Verb	ˈsæiløtːæneːn
säilötään	Verb	ˈsæiløtæːn
säkeistö	Noun	ˈsækeistø
sälli	Noun	ˈsælːi
särjen	Noun	ˈsærje̞n
särkeä	Noun	ˈsærkeæ
särki	Noun	ˈsærki
särkylääke	Noun	ˈsærkyˌlæːke̞ˣ
särkynyt	Verb	ˈsærkynyt
särkyä	Noun	ˈsærkyæ
särmä	Noun	ˈsærmæ
sävy	Noun	ˈsæʋy
säyne	Noun	ˈsæyne̞ˣ
säädellä	Verb	ˈsæːde̞lːæˣ
sääri	Noun	ˈsæːri
sääriluu	Noun	ˈsæːriˌluː
säästää	Verb	ˈsæːstæː(ʔ)
säästöpossu	Noun	ˈsæːstøˌposːu
sääty	Noun	ˈsæːty
säätää	Verb	ˈsæːtæːˣ
söisi	Verb	ˈsø̞isi
takahuone	Noun	ˈtɑkɑˌhuɔne
takaisin	Adverb	ˈtɑkɑisin
takamaa	Noun	ˈtɑkɑˌmɑː
takamus	Noun	ˈtɑkɑmus
takaovi	Noun	ˈt̪ɑkɑˌo̞ʋi
takapuoli	Noun	ˈt̪ɑkɑˌpuɔli
takavokaali	Noun	ˈtɑkɑˌʋokɑːli
takia	Noun	ˈtɑkiɑ
takiainen	Noun	ˈtɑkiɑinen
takioni	Noun	ˈtɑkioni
takka	Verb	ˈtʰaʰkːa
takki	Noun	ˈtɑkːi
takku	Noun	ˈtɑkːu
taklaaja	Noun	ˈtɑklɑːjɑ
takoi	Verb	ˈtɑkoi
taksi	Noun	ˈt̪ɑksi
taksin	Noun	ˈtɑksin
takuu	Noun	ˈtɑkuː
takyoni	Noun	ˈtɑkyoni
tali	Noun	ˈtɑli
talikko	Noun	ˈt̪ɑlikːo̞
talirauhanen	Noun	ˈtɑliˌrɑuɦɑnen
talja	Noun	ˈtɑljɑ
talkki	Noun	ˈt̪ɑlkːi
talkkuna	Noun	ˈt̪ɑlkːunɑ
talla	Verb	ˈtɑlːɑ
tallaaja	Noun	ˈt̪ɑlːɑːjɑ
tallata	Verb	ˈtɑlːɑtɑˣ
tallelokero	Noun	ˈtɑlːelˌlokero
talli	Verb	ˈtɑlːi
tallipäitset	Noun	ˈt̪ɑlːiˌpæit̪se̞t̪
tallium	Noun	ˈt̪ɑlːi͡um
talo	Noun	ˈtɑlo
talous	Noun	ˈt̪ɑlo̞us
talouspaperi	Noun	ˈtɑlousˌpɑperi
taltta	Noun	ˈt̪ɑl̪t̪ːɑ
taluttaa	Verb	ˈtɑlutːɑːˣ
talutusnuora	Noun	ˈtɑlutusˌnuorɑ
talvi	Noun	ˈtɑlʋi
talviaika	Noun	ˈtɑlʋiˌɑi̯kɑ
talviloma	Noun	ˈtɑlʋiˌlomɑ
talvipäivänseisaus	Noun	ˈtɑlviˌpæivænseisɑus
talviturkki	Noun	ˈtɑlʋiˌturkːi
tamaani	Noun	ˈt̪ɑmɑːni
tamariini	Noun	ˈtɑmɑriːni
tamburiini	Noun	ˈt̪ɑmburiːni
tamma	Noun	ˈtɑmːɑ
tammi	Noun	ˈtɑmːi
tammihärkä	Noun	ˈtɑmːiˌhærkæ
tamminkainen	Noun	ˈtɑmːinkɑinen
tammivireo	Noun	ˈtɑmːiˌʋireo
tamponi	Noun	ˈt̪ɑmpo̞ni
tango	Noun	ˈtæŋɡəʊ
tanka	Noun	ˈt̪ɑŋkɑ
tanko	Noun	ˈtɑŋko
tansaniitti	Noun	ˈt̪ɑnsɑniːt̪ːi
tanskalainen	Noun	ˈtɑnskɑˌlɑinen
tanskalaistaa	Verb	ˈtɑnskɑlɑi̯stɑːˣ
tanssiaskel	Noun	ˈtɑnsːiˌɑskel
tanssii	Verb	ˈt̪ɑnsːiː
tanssija	Noun	ˈt̪ɑnsːijɑ
tanssilattia	Noun	ˈtɑnsːiˌlɑtːiɑ
tanssittaa	Verb	ˈtɑnsːitːɑː(ʔ)
tantaali	Noun	ˈt̪ɑn̪t̪ɑːli
tantta	Noun	ˈt̪ɑn̪t̪ːɑ
tao	Noun	daʊ
taottava	Adjective	ˈtɑotːɑʋɑ
tapa	Noun	ˈtɑːpə
tapahtumapaikka	Noun	ˈtɑpɑɦtumɑˌpɑikːɑ
tapas	Noun	ˈtæp.æs
tapaus	Noun	ˈtɑpɑus
tapetti	Noun	ˈtɑpetːi
tapioka	Noun	ˈtɑpiokɑ
tappaa	Verb	ˈtɑpːɑː(ʔ)
tappaakaksikärpästäyhdelläiskulla	Verb	ˈtɑpːɑːˈkːɑksi ˈkærpæstæ ˈycdelːæ ˈiskulːɑ
tappara	Noun	ˈtɑpːɑrɑ
tappelu	Noun	ˈtɑpːelu
tappi	Noun	ˈtɑpːi
tappura	Noun	ˈtɑpːurɑ
tapsi	Noun	ˈt̪ɑpsi
taputus	Noun	ˈt̪ɑput̪us
tariffi	Noun	ˈt̪ɑrifːi
tarina	Noun	ˈtɑrinɑ
tarjeta	Verb	ˈtɑrjetɑ(ʔ)
tarjoilija	Noun	ˈt̪ɑrjo̞ilijɑ
tarjous	Noun	ˈt̪ɑrjo̞͡us
tarkastaja	Noun	ˈt̪ɑrkɑstɑjɑ
tarkastusleima	Noun	ˈtɑrkɑstusˌleimɑ
tarke	Noun	ˈt̪ɑrke̞ˣ
tarkentaa	Verb	ˈtɑrkentɑː
tarkentua	Verb	ˈtɑrkentuɑ(ʔ)
tarketa	Verb	ˈtɑrketɑ(ʔ)
tarkkailija	Noun	ˈt̪ɑrkːɑ͡ilijɑ
tarpeeton	Adjective	ˈt̪ɑrpe̞ːt̪o̞n
tarra	Noun	tarːa
tartunnanlevittäjä	Noun	ˈtɑrtunːɑnˌleʋitːæjæ
taru	Noun	ˈtɑru
tarve	Noun	ˈtɑrʋeˣ
tarvittaessa	Adverb	ˈt̞ɑrʋiˌt̪ːɑ.e̞sːɑ
tasalämpöisyys	Noun	ˈtasaˌlæmpøisyːs
tasanko	Noun	ˈtɑsɑŋko
tasapainoaisti	Noun	ˈt̪ɑsɑˌpɑino̞ˌɑisti
tasapeli	Noun	ˈt̪ɑsɑˌpe̞li
tasasoukka	Adjective	ˈtɑsɑˌsoukːɑ
tasata	Verb	ˈt̪ɑsɑt̪ɑ(ʔ)
tasauspyörästö	Noun	ˈtɑsɑusˌpyøræstø
tase	Verb	teɪz
tasku	Verb	ˈtɑsku
taso	Noun	ˈtaso
tasoa	Noun	ˈtɑsoɑ
tasoristeys	Noun	ˈtɑsoˌristeys
tau	Noun	taʊ
taulu	Noun	ˈtɑu̯lu
taulutietokone	Noun	ˈtɑuluˌtietoˌkoneˣ
taus	Noun	ˈt̪ɑus
tausta	Noun	ˈt̪ɑustɑ
taustaa	Noun	ˈtɑustɑː
taustakuva	Noun	ˈtɑustɑˌkuʋɑ
taustalevy	Noun	ˈtɑustɑˌleʋy
taustasäteily	Noun	ˈt̪ɑustɑˌsæt̪e̞ily
taustatieto	Noun	ˈtɑustɑˌtieto
taustaväri	Noun	ˈtɑustɑˌʋæri
tauti	Noun	ˈt̪ɑut̪i
tavara	Noun	ˈtɑʋɑrɑ
tavarajuna	Noun	ˈt̪ɑʋɑrɑˌjunɑ
tavata	Verb	ˈtɑvɑtɑ
tavi	Noun	ˈtɑʋi
tavoite	Noun	ˈtɑʋoite
tavoittaa	Verb	ˈt̪ɑʋo̞it̪ːɑːˣ
tavoittelee	Verb	ˈt̪ɑʋo̞it̪ːe̞le̞ː
tavu	Noun	ˈtɑʋu
tavuviiva	Noun	ˈt̪ɑʋuˌʋiːʋɑ
taxfree	Adjective	ˈt̪æksfriː
te	Noun	tiː
tee	Noun	tiː
teekkari	Noun	ˈteːkːɑri
teelusikka	Noun	ˈt̪e̞ːˌlusikːɑ
teemme	Verb	ˈteːmːe
teenä	Noun	ˈteːnæ
teeri	Noun	ˈteːri
tehden	Verb	ˈte̞xde̞n
tehdessä	Verb	ˈtehdesːæ
tehdä	Verb	ˈtehdæˣ
tehdäkauppansa	Verb	ˈteɦdæˣ ˈkːɑupːɑnsɑ(ʔ)
tehdään	Verb	ˈtehdæːn
tehkää	Verb	ˈtehkæː
tehkäämme	Verb	ˈtehkæːmːe
tehkö	Verb	ˈtehkø(ʔ)
teho	Noun	ˈteho
tehoosasto	Noun	ˈt̪e̞ɦo̞ˌo̞sɑsto̞
tehoste	Noun	ˈteɦoste(ʔ)
tehtiin	Verb	ˈtehtiːn
tehtäessä	Verb	ˈtehtæesːæ
tehtäisi	Verb	ˈtehtæisi
tehtäkö	Verb	ˈtehtækø(ʔ)
tehtäköön	Verb	ˈtehtækøːn
tehtämän	Verb	ˈtehtæmæn
tehtäne	Verb	ˈtehtæne(ʔ)
tehtäneen	Verb	ˈtehtæneːn
teidän	Pronoun	ˈteidæn
teihin	Noun	ˈteihin
teiksi	Pronoun	ˈteiksi
teille	Pronoun	ˈteilːe(ʔ)
teillä	Pronoun	ˈteilːæ
teiltä	Pronoun	ˈteiltæ
teinipeili	Noun	ˈtei̯nipei̯li
teinä	Pronoun	ˈteinæ
teippi	Noun	ˈteipːi
teissä	Noun	ˈteisːæ
teistä	Pronoun	ˈteistæ
teititellä	Verb	ˈteititelːæ(ʔ)
teittä	Noun	ˈteitːæ
teitä	Pronoun	ˈteitæ
tekemissä	Verb	ˈtekemisːæ
tekemäisillään	Verb	ˈtekemæiˌsilːæni
tekemän	Verb	ˈtekemæn
tekemässä	Verb	ˈtekemæsːæ
tekemästä	Verb	ˈtekemæstæ
tekemättä	Verb	ˈtekemætːæ
tekisi	Verb	ˈtekisi
tekopyhyys	Noun	ˈtekoˌpyhyːs
tekopyhä	Adjective	ˈtekoˌpyhæ
tekstaaja	Noun	ˈtekstɑːjɑ
teksti	Noun	ˈteksti
tekstiviesti	Noun	ˈtekstiˌʋiesti
tela	Noun	ˈtelɑ
telaketju	Noun	ˈtelɑˌketju
teline	Noun	ˈt̪e̞line̞ˣ
teljo	Noun	ˈteljo
tempoi	Verb	ˈtempoi
tennis	Noun	ˈtɛ.nɪs
tenä	Noun	ˈtenæ
teoria	Noun	ˈteoriɑ
teos	Noun	ˈt̪e̞.o̞s
tepä	Pronoun	ˈtepæ
teriö	Noun	ˈt̪e̞riø̞
terminaali	Noun	ˈterminɑːli
teroitin	Noun	ˈt̪e̞ro̞it̪in
teroittaa	Verb	ˈt̪e̞ro̞it̪ːɑːˣ
terrieri	Noun	ˈterːieri
terva	Noun	ˈt̪e̞rʋɑ
tervapeippo	Noun	ˈt̪e̞rʋɑˌpe̞ipːo̞
tervapääsky	Noun	ˈterʋɑˌpæːsky
terve	Verb	ˈterʋeˣ
terveesti	Adverb	ˈt̪e̞rʋe̞ːsti
tervehtiä	Verb	ˈterʋextiæ
terveisiä	Noun	ˈterveisiæ
tervemenoa	Interjection	ˈt̪e̞rʋe̞ˌmːeno̞.ɑ
tervetuloa	Interjection	ˈterʋeˣˌtuloɑ
terveydenhoitaja	Noun	ˈterʋeydenˌhoitɑjɑ
terveydenhuolto	Noun	ˈt̪e̞rʋe̞yde̞nˌxuɔlto̞
terveys	Noun	ˈterʋeys
terveyskeskus	Noun	ˈterʋeysˌkeskus
terveysside	Noun	ˈterʋeysˌside(ʔ)
terä	Noun	ˈt̪e̞ræ
teräsbetoni	Noun	ˈteræsˌbetoni
testata	Verb	ˈtestɑtɑˣ
tet	Noun	tet
teurastaja	Noun	ˈteurɑstɑjɑ
thai	Noun	tɑi
theeta	Noun	ˈteːtɑ
tiedemies	Noun	ˈt̪iedeˌmːies
tiedonpakkaus	Noun	ˈtiedomˌpɑkːɑus
tiedonsiirto	Noun	ˈtiedonˌsiːrto
tiedosto	Noun	ˈt̪ie̞do̞st̪o̞
tiedottaja	Noun	ˈtiedotːɑjɑ
tiehyt	Noun	ˈt̪ie̞ɦyt̪
tiekartta	Noun	ˈtieˌkɑrtːɑ
tienvarsi	Noun	ˈtienˌʋɑrsi
tienvarsipommi	Noun	ˈtienˌʋɑrsiˌpomːi
tiera	Noun	ˈt̪ie̞rɑ
tieteenfilosofia	Noun	ˈt̪ie̞t̪e̞ːnˌfilo̞so̞fiɑ
tieteenteoria	Noun	ˈtieteːnˌteoriɑ
tieto	Noun	ˈt̪ie̞t̪o̞
tietoinen	Adjective	ˈtietoinen
tietoisuus	Noun	ˈtietoisuːs
tietojenkäsittely	Noun	ˈtietojenˌkæsitːely
tietojenkäsittelytiede	Noun	ˈtietojenˌkæsitːelyˌtiede(ʔ)
tietokantahallinnoija	Noun	ˈtietoˌkɑntɑˌhɑlːinːoijːɑ
tietokantaohjelma	Noun	ˈtietoˌkɑntɑˌoxjelmɑ
tietokonegrafiikka	Noun	ˈtietoˌkoneˌɡːrɑfiːkːɑ
tietotyyppi	Noun	ˈtietoˌtyːpːi
tietoyhteiskunta	Noun	ˈtietoˌyhteisˌkuntɑ
tietty	Adjective	ˈtietːy(ʔ)
tietue	Noun	ˈtietue(ʔ)
tietulli	Noun	ˈt̪ie̞ˌt̪ulːi
tietää	Verb	ˈtie̯tæːˣ
tiibet	Noun	ˈtiːbet
tiibetinvesipäästäinen	Noun	ˈtiːbetinˌʋesiˌpæːstæinen
tiilittää	Verb	ˈtiːlitːæː
tiimalasi	Noun	ˈtiːmɑlɑsi
tiine	Adjective	ˈtiːneˣ
tiinehtiä	Verb	ˈtiːnehtiæˣ
tiistai	Noun	ˈt̪iːstɑi
tiivistelmä	Noun	ˈtiːʋistelmæ
tikku	Noun	ˈtikːu
tikkunekku	Noun	ˈtikːuˌnekːu
tila	Verb	ˈtilɑ
tilasto	Noun	ˈtilɑsto
tilastotiede	Noun	ˈtilɑstoˌtiede(ʔ)
tilausnumero	Noun	ˈt̪ilɑusˌnume̞ro̞
tilde	Noun	ˈtɪldə
tili	Noun	ˈtili
tilli	Noun	ˈtilːi
tilpehööri	Noun	ˈt̪ilpe̞ɦø̞ːri
tilsa	Noun	ˈt̪ilsɑ
tiltaltti	Noun	ˈtiltɑltːi
tiluttaa	Verb	ˈtilutːɑː
timantti	Noun	ˈtimɑntːi
timjami	Noun	ˈtimjɑmi
tina	Noun	ˈtinɑ
tinkiä	Verb	ˈt̪iŋki.æˣ
tippuri	Noun	ˈt̪ipːuri
tippuu	Verb	ˈt̪ipːuː
tipula	Noun	ˈtipulɑ
tiramisu	Noun	ˌtɪɹəmɪˈsuː
tirehtööri	Noun	ˈt̪ire̞ht̪ø̞ːri
tiskaaja	Noun	ˈtiskɑːjɑ
titaani	Noun	ˈt̪it̪ɑːni
tiu	Numeral	ˈt̪iu
tiukkua	Verb	tiukːuɑˣ
tiukkuus	Noun	ˈtiukːuːs
tiuku	Noun	ˈtiu̯ku
tivata	Verb	ˈtivɑtɑ(ʔ)
tivoli	Noun	ˈtiʋoli
to	Particle	tuː
todellinen	Adjective	ˈtodelːinen
toden	Noun	ˈtoden
todennäköinen	Adjective	ˈt̪o̞de̞nˌnækø̞ine̞n
todentullen	Adverb	ˈtoden ˈtulːen
todeta	Verb	ˈtodetɑ(ʔ)
todistaa	Verb	ˈtodistɑː(ʔ)
todistajanlausunto	Noun	ˈtodistɑjɑnˌlɑusunto
todiste	Noun	ˈtodiste(ʔ)
toffee	Noun	ˈtɒfi
tofujäätelö	Noun	ˈtofuˌjæːtelø
tohkeissaan	Adverb	ˈtohkeisːɑːn
tohtia	Verb	ˈto̞xti.ɑˣ
tohtori	Noun	ˈt̪oxt̪ori
tohveli	Noun	ˈtoxʋeli
tohvelieläin	Noun	ˈtoxʋeliˌelæin
toi	Verb	toi
toimenpide	Noun	ˈtoimempide
toimi	Noun	ˈtoimi
toimia	Noun	ˈto̞imi.ɑ
toiminta	Noun	ˈt̪o̞imin̪t̪ɑ
toimittaa	Verb	ˈtoimitːɑː(ʔ)
toimitus	Noun	ˈtoimitus
toinen	Adjective	ˈtoi̯nen
toinenkotimainen	Noun	ˈtoineŋˈkotiˌmɑinen
toinenmaailmansota	Noun	ˈtoinemˈmɑːilmɑnˌsotɑ
toipilas	Noun	ˈt̪o̞ipilɑs
toisensa	Pronoun	ˈtoisensɑ(ʔ)
toisi	Verb	ˈt̪o̞isi
toista	Pronoun	ˈtoistɑ
toistaa	Verb	ˈtoistɑː(ʔ)
toive	Noun	ˈtoiʋe(ʔ)
toivoa	Noun	ˈtoi̯ʋoɑ
toki	Noun	ˈtoki
tokiolainen	Adjective	ˈtokiolɑi̯nen
tokko	Noun	ˈtokːo
toksiini	Noun	ˈtoksiːni
tolkku	Noun	ˈtolkːu
tollo	Adjective	ˈtolːo
tolvana	Noun	ˈtolʋɑnɑ
tomaatit	Noun	ˈtomɑːtit
tomusokeri	Noun	ˈtomuˌsokeri
tonkia	Verb	ˈt̪o̞ŋki.ɑˣ
tooga	Noun	ˈtoːɡɑ
toonika	Noun	ˈtoːnikɑ
torakka	Noun	ˈtorɑkːɑ
torikammo	Noun	ˈtoriˌkɑmːo
tornipöllö	Noun	ˈtorniˌpølːø
torpedo	Noun	ˌtɔː(ɹ)ˈpiː.dəʊ
torpedoida	Verb	ˈt̪o̞rpe̞do̞idɑ
torsio	Noun	ˈtorsio
torstai	Noun	ˈt̪o̞rstɑi
torut	Noun	ˈt̪o̞rut̪
torvijäkälä	Noun	ˈtorʋiˌjækælæ
tosa	Noun	tʰɔːsa
tosi	Noun	ˈtosi
tosissaan	Adverb	ˈtosisːɑːn
tossu	Noun	ˈt̪o̞sːu
totaalikieltäytyminen	Noun	ˈtotɑːliˌkieltæyˌtyminen
toteemi	Noun	ˈtoteːmi
toteutua	Verb	ˈtoteutuɑ(ʔ)
totta	Interjection	ˈtotːɑ
tottakai	Adverb	ˈt̪o̞t̪ːɑˈkɑi
totuus	Noun	ˈtotuːs
touchdown	Noun	ˈtʌtʃdaʊn
toukka	Noun	ˈtou̯kːɑ
toveri	Noun	ˈtoʋeri
tovi	Noun	ˈtoʋi
traakkipuu	Noun	ˈtrɑːkːiˌpuː
trap	Noun	tɹæp
trapetsi	Noun	ˈt̪rɑpe̞t̪si
tri	Noun	tɹaɪ
trollata	Verb	ˈt̪ro̞lːɑt̪ɑˣ
trukki	Noun	ˈtrukːi
tsaari	Noun	ˈtsɑːri
tseta	Noun	ˈtsetɑ
tsygä	Noun	ˈtsyɡæ
tsätti	Noun	ˈtsætːi
tue	Noun	ˈtu.e
tuhatjalkainen	Noun	ˈtuhɑtˌjɑlkɑinen
tuhka	Noun	ˈtuxkɑ
tuhkavarpunen	Noun	ˈt̪uxkɑˌʋɑrpun̪e̞n̪
tuhma	Adjective	ˈt̪uhmɑ
tuijotella	Verb	ˈt̪uijo̞t̪e̞lːɑˣ
tuijottaa	Verb	ˈt̪uijo̞t̪ːɑːˣ
tuiki	Adverb	ˈt̪uiki
tuikkia	Verb	ˈt̪uikːi.ɑˣ
tuima	Adjective	ˈt̪uimɑ
tukanleikkuu	Noun	ˈtukɑnˌleikːuː
tukehtua	Verb	ˈt̪uke̞xt̪u.ɑ
tukia	Noun	ˈtukiɑ
tukipaketti	Noun	tukipɑketti
tukka	Noun	ˈtukːɑ
tukkia	Noun	ˈtukːi.ɑ
tulehdus	Noun	ˈtulehdus
tuleva	Adjective	ˈtulevɑ
tulevaisuus	Noun	ˈtulevɑisuːs
tuli	Noun	ˈtuli
tulikettu	Noun	ˈtuliˌketːu
tulitikku	Noun	ˈt̪uliˌt̪ikːu
tulivuori	Noun	ˈtuliˌʋuɔri
tulkitaan	Verb	ˈt̪ulkit̪ɑːn
tulla	Verb	ˈtulːɑˣ
tullen	Verb	tulːen
tulli	Noun	ˈtulːi
tulonsiirto	Noun	ˈtulonˌsiːrto
tulos	Noun	ˈtulos
tulostaa	Verb	ˈt̪ulo̞st̪ɑː(ʔ)
tuloste	Noun	ˈtuloste(ʔ)
tulostin	Noun	ˈt̪ulo̞stin
tulva	Noun	ˈtulʋɑ
tulvavuoksi	Noun	ˈtulʋɑˌʋuoksi
tuma	Noun	tʰuˈma
tumajyvänen	Noun	ˈtumɑˌjyʋænen
tumma	Adjective	ˈtumːɑ
tummajättiläishyppypäästäinen	Noun	ˈtumːɑˌjætːilæisˌcypːyˌpæːstæinen
tummanpunainen	Adjective	ˈtumːɑmˌpunɑinen
tumppu	Noun	ˈtumpːu
tundrasusi	Noun	ˈtundrɑˌsusi
tunge	Noun	tɔnɡə
tungos	Noun	ˈtuŋːos
tunika	Noun	tuːnika
tunkea	Verb	ˈt̪uŋke̞.ɑˣ
tunkio	Noun	ˈt̪uŋkio̞
tunkki	Noun	ˈtuŋkːi
tunne	Noun	ˈtunːe(ʔ)
tunnistettava	Adjective	ˈtunːisˌtetːɑʋɑ
tunnollinen	Adjective	ˈtunːolːinen
tunnollisuus	Noun	ˈtunːolːisuːs
tunnontarkka	Adjective	ˈtunːonˌtɑrkːɑ
tunnontarkkuus	Noun	ˈtunːonˌtɑrkːuːs
tunnukseton	Adjective	ˈˈt̪unːukset̪o̞n
tunnus	Noun	ˈt̪unːus
tunti	Noun	ˈtunti
tuntipalkka	Noun	ˈtuntiˌpɑlkːɑ
tuntua	Noun	ˈtuntuɑ
tunturisopuli	Noun	ˈtunturiˌsopuli
tuo	Verb	ˈtuo̯
tuoda	Verb	ˈtuo̯dɑˣ
tuohtua	Verb	ˈt̪uɔxt̪u.ɑ
tuoksuvalmuska	Noun	ˈt̪uɔksuˌʋɑlmuskɑ
tuoli	Noun	ˈtuo̯li
tuolla	Pronoun	ˈtuolːɑ
tuoma	Verb	ˈtuomɑ
tuomari	Noun	ˈtuomɑri
tuomi	Noun	ˈtuo̞mi
tuomioistuin	Noun	ˈtuomioˌistuin
tuomiovirhe	Noun	ˈt̪uɔmi.o̞ˌʋirɦe̞ˣ
tuomita	Verb	ˈtuomitɑˣ
tuoni	Noun	ˈtuɔni
tuonpuoleinen	Adjective	ˈtuomˌpuoleinen
tuota	Noun	ˈtuotɑ
tuote	Noun	ˈtuote(ʔ)
tuotemerkki	Noun	ˈtuɔteˌmːerkːi
tuottaa	Verb	ˈtuotːɑː(ʔ)
tupaantuliaiset	Noun	ˈtupɑːnˌtuliɑiset
tupakoida	Verb	ˈt̪upɑko̞idɑˣ
tupakoimattomuus	Noun	ˈtupɑkoimɑtːomuːs
tupakointi	Noun	ˈtupɑkointi
tuparit	Noun	ˈtupɑrit
tupasluikka	Noun	ˈtupɑsˌluikːɑ
tupasvilla	Noun	ˈtupɑsˌʋilːɑ
tuplata	Verb	ˈt̪uplɑt̪ɑˣ
tuppilo	Noun	ˈtupːilo
turha	Adjective	ˈturɦɑ
turhautua	Verb	ˈt̪urxɑut̪uɑˣ
turista	Noun	tuˈɾis.tə
turkoosi	Adjective	ˈt̪urkoːsi
turnipsi	Noun	ˈturnipsi
turut	Noun	t̪urut̪
turvasatama	Noun	ˈturʋɑˌsɑtɑmɑ
turve	Verb	ˈt̪urʋe̞
tuska	Noun	ˈtuskɑ
tuskallinen	Adjective	ˈt̪uskɑlːine̞n
tuskanhiki	Noun	ˈtuskɑnˌhiki
tuskastella	Verb	ˈtuskɑstelːɑˣ
tuskin	Adverb	ˈtuskin
tutia	Verb	ˈt̪ut̪i.ɑˣ
tutina	Noun	ˈt̪ut̪inɑ
tutine	Verb	ˈt̪ut̪ine̞ˣ
tutka	Noun	ˈt̪ut̪kɑ
tutkimus	Noun	ˈtutkimus
tutsi	Noun	ˈtutsi
tuttipullo	Noun	ˈtutːiˌpulːo
tuuli	Noun	ˈtuːli
tuulivoima	Noun	ˈt̪uːliˌʋo̞imɑ
tuulla	Verb	ˈtuːlːɑˣ
tuullen	Verb	tuːlːen
tuuppia	Verb	ˈtuːpːi.ɑˣ
tviitata	Verb	ˈtʋiːtɑtɑˣ
tweed	Noun	ˈtʋiːdi
twiitata	Verb	ˈtʋiːtɑtɑˣ
twist	Noun	twɪst
tyrmistyttää	Verb	ˈtyrmistytːæː(ʔ)
tyrni	Noun	ˈtyrni
tyttö	Noun	tytːø
tyynelle	Adjective	ˈt̪yːne̞lːe̞
tyyni	Adjective	ˈtyːni
tyyrpuuri	Noun	ˈtyːrpuːri
työ	Noun	tyø
työaika	Noun	ˈtyøˌɑikɑ
työehtosopimus	Noun	ˈtyøˌehtoˌsopimus
työmaakypärä	Noun	ˈtyøˌmɑːˌkypæræ
työmarkkinatuki	Noun	ˈtyøˈmarkːinaˈtuki
työnantaja	Noun	ˈtyønˌɑntɑjɑ
työntää	Verb	ˈtyøntæː
työpaikka	Noun	ˈt̪yøˌpɑikːɑ
työsopimus	Noun	ˈtyøˌsopimus
työttömyys	Noun	ˈtyøtːømyːs
työväentalo	Noun	ˈt̪yøˌʋæe̞nˌt̪ɑlo̞
täbäri	Noun	ˈtæbæri
tähde	Noun	ˈt̪æçde̞
tähkylä	Noun	ˈt̪æckylæ
tähtisumu	Noun	ˈtæctiˌsumu
täi	Noun	tˈæi̯
täky	Noun	ˈtæky
tämä	Pronoun	ˈtæmæ
tänne	Adverb	ˈtænːe̞ˣ
täplä	Noun	ˈt̪æplæ
tärkein	Adjective	ˈt̪ærkein
tärkeä	Adjective	ˈt̪ærke̞æ
tässä	Pronoun	ˈtæsːæ
tässäjanyt	Adverb	ˈtæsːæ jɑ nyt
täti	Noun	ˈtæti
täydy	Verb	ˈtæydy(ʔ)
täytekakku	Noun	ˈtæyteˣ
täytyi	Verb	ˈtæytyi
täytyisi	Verb	ˈtæytyisi
täytyne	Verb	ˈtæytyne(ʔ)
täytynee	Verb	ˈtæytyneː
täytynyt	Verb	ˈtæytynyt
täytyy	Verb	ˈtæy̯tyː
täytyä	Verb	ˈtæɥtyæ(ʔ)
täällä	Adverb	ˈtæːlːæ
töintuskin	Adverb	ˈtøin ˈtuskin
tölkinavaaja	Noun	ˈtølkinˌɑʋɑːjɑ
törmätä	Verb	ˈtørmætæˣ
törmäys	Noun	ˈtørmæys
tšekki	Noun	ˈtʃekːi
uhka	Noun	ˈuxkɑ
uhkailla	Verb	ˈuxkɑilːɑˣ
uhkailu	Noun	ˈuhkɑilu
uhkapeli	Noun	ˈuhkɑˌpeli
uhmata	Verb	ˈuhmɑtɑ(ʔ)
uhri	Noun	ˈuxri
ui	Noun	œj
uida	Verb	ˈui̯dɑˣ
uiden	Verb	ˈuide̞n
uija	Noun	ˈuijːɑ
uimaasu	Noun	ˈuimɑʔˌɑsu
uinen	Verb	ˈuinen
uinti	Noun	ˈuin̪t̪i
uintimatka	Noun	ˈuintiˌmɑtkɑ
uivelo	Noun	ˈuiʋelo
ujostelematon	Adjective	ˈujosteleˌmɑton
ujostella	Verb	ˈujostelːɑˣ
ujous	Noun	ˈujous
ukaasi	Noun	ˈukɑːsi
ukkeli	Noun	ˈukːeli
ukki	Noun	ˈukːi
ukko	Noun	ˈukːo
ukkonen	Noun	ˈukːonen
ukkosmyrsky	Noun	ˈukːosˌmyrsky
uksi	Noun	ˈuksi
ulkoa	Adverb	ˈulkoɑ
ulkona	Adverb	ˈulko̞nɑ
ulkoydin	Noun	ˈulko̞ˌydin
ullakko	Noun	ˈulːɑkːo
ullakkohuone	Noun	ˈulːɑkːoˌhuɔneˣ
uloin	Adjective	ˈulo̞in
uloke	Noun	ˈulo̞ke̞ˣ
ulos	Adverb	ˈulos
ultimate	Adjective	ˈʌltɪmɪt
ulvo	Noun	ˈulʋo
ulvoa	Noun	ˈulʋoɑˣ
ulvoi	Verb	ˈulʋoi
ummetus	Noun	ˈumːet̪us
ummikko	Noun	ˈumːikːo
umpikuja	Noun	ˈumpiˌkujɑ
umpimurtuma	Noun	ˈumpiˌmurtumɑ
umpimähkään	Adverb	ˈumpiˌmæçkæːn
undulaatti	Noun	ˈundulɑːtːi
uneliaisuus	Noun	ˈuneliɑisuːs
unelmaammatti	Noun	ˈunelmɑʔˌɑmːɑtːi
unelmaloma	Noun	ˈunelmɑˌlomɑ
unenomaisuus	Noun	ˈunenˌomɑisuːs
unenpuute	Noun	ˈunemˌpuːteˣ
unettomuus	Noun	ˈunetːomuːs
unhola	Noun	ˈunholɑ
uni	Noun	ˈjuː.niː
uniasu	Noun	ˈuniˌɑsu
unihalvaus	Noun	ˈuniˌxɑlʋɑus
uniikkikappale	Noun	ˈuniːkːiˌkɑpːɑle
unikeko	Noun	ˈuniˌke̞ko̞
unilääke	Noun	ˈuniˌlæːke̞ˣ
unissakävelijä	Noun	ˈunisːɑˌkæʋelijæ
unissakävely	Noun	ˈunisːɑˌkæʋe̞ly
unisuus	Noun	ˈunisuːs
univaje	Noun	ˈuniˌʋɑje̞ˣ
univelka	Noun	ˈuniˌʋe̞lkɑ
universaalisuus	Noun	ˈuniʋersɑːlisuːs
unkari	Noun	ˈuŋkɑri
unohdella	Verb	ˈuno̞xde̞lːɑˣ
untuva	Noun	ˈuntuʋɑ
uoma	Noun	ˈuomɑ
upottaa	Verb	ˈupotːɑː(ʔ)
upotus	Noun	ˈupotus
uraani	Noun	ˈurɑːni
urakehitys	Noun	ˈurɑˌkeɦitys
urkkia	Verb	ˈurkːi.ɑˣ
urkuharmoni	Noun	ˈurkuˌhɑrmoni
uros	Noun	ˈuros
urpiainen	Noun	ˈurpiɑinen
uruguaylainen	Adjective	ˈuruɡuɑiˌlɑinen
urut	Noun	uɹʊt̚ 
usein	Adverb	ˈuse̞in
uskallus	Noun	ˈuskɑlːus
uskaltaa	Verb	ˈuskɑltɑː(ʔ)
uskaltaudun	Verb	ˈuskɑl̪ˌt̪ɑudun
uskollisuudenvala	Noun	ˈuskolːisuːdenˌʋɑlɑ
uskollisuus	Noun	ˈuskolːisuːs
uskottava	Adjective	ˈuskotːɑʋɑ
utu	Noun	ˈutu
uu	Noun	ˈuː
uudelleenarviointi	Noun	ˈuːdelːeːnˌɑrʋiointi
uudelleenkoulutus	Noun	ˈuːdelːeːŋˌkoulutus
uudelleensijoitus	Noun	ˈuːdelːeːnˌsijoitus
uudenaikaisuus	Noun	ˈuːdenˌɑikɑisuːs
uudennu	Verb	ˈuːde̞nːuˣ
uudenvuodenpäivä	Noun	ˈuːdenˌʋuo̯denˌpæi̯ʋæ
uudistaa	Verb	ˈuːdistɑː(ʔ)
uudistaja	Noun	ˈuːdistɑjɑ
uuhi	Noun	ˈuːɦi
uumen	Noun	ˈuːme̞n
uuni	Noun	ˈuːni
uunikala	Noun	ˈuːniˌkɑlɑ
uunilintu	Noun	ˈuːniˌlintu
uunimakkara	Noun	ˈuːniˌmɑkːɑrɑ
uuniruoka	Noun	ˈuːniˌruɔkɑ
uurna	Noun	ˈuːrnɑ
uurre	Noun	ˈuːrːe(ʔ)
uurteinen	Adjective	ˈuːrteinen
uus	Prefix	uːs
uusbarokki	Noun	ˈuːsˌbɑrokːi
uusfasisti	Noun	ˈuːsˌfɑsisti
uusfasistinen	Adjective	ˈuːsˌfɑsistinen
uusia	Adjective	ˈuːsiɑ
uusinta	Noun	ˈuːsin̪t̪ɑ
uusivuosi	Noun	ˈuːsiˌʋuo̯si
uuslatina	Noun	ˈuːsˌlɑtinɑ
uute	Noun	ˈuːt̪e̞ˣ
uutinen	Noun	ˈuːt̪ine̞n
uutisfilmi	Noun	ˈuːtisˌfilmi
uutiskuvaaja	Noun	ˈuːtisˌkuʋɑːjɑ
uutispalvelu	Noun	ˈuːtisˌpɑlʋelu
uutispommi	Noun	ˈuːtisˌpomːi
uutisvuoto	Noun	ˈuːtisˌʋuɔto
uuttaa	Verb	ˈuːtːɑː(ʔ)
vainu	Noun	ˈʋɑinu
vaippapaviaani	Noun	ˈʋɑipːɑˌpɑʋiɑːni
vaiti	Adverb	ˈʋɑit̪i
vajaa	Adjective	ˈʋɑjɑː
vajaatyöllisyys	Noun	ˈʋɑjɑːˌtyølːisyːs
vaje	Noun	ˈʋɑje̞ˣ
vakaa	Adjective	ˈʋɑkɑː
vakaasti	Adverb	ˈʋɑkɑːsti
vakava	Adjective	ˈʋɑkɑʋɑ
vakavissaan	Adverb	ˈvɑkɑvisːɑːn
vakio	Noun	ˈʋɑkio̞
vakiovieras	Noun	ˈʋɑkioˌʋierɑs
vakuoli	Noun	ˈʋɑkuo̯li
vakuuttaa	Verb	ˈvɑkuːtːɑː(ʔ)
vakuutus	Noun	ˈvɑkuːtus
vakuutuspetos	Noun	ˈvɑkuːtusˌpetos
vakuutusyhtiö	Noun	ˈvɑkuːtusˌyçtiø
vala	Noun	ˈʋɑlɑ
valaa	Noun	ˈʋɑlɑː
valaisin	Noun	ˈʋɑlɑisin
valaista	Verb	ˈʋɑlɑi̯stɑˣ
valaistusmestari	Noun	ˈʋɑlɑistusˌmestɑri
vale	Noun	veɪl
valehdella	Verb	ˈʋɑlehdelːɑˣ
valehdellen	Verb	ˈvɑlehdelːen
valehtelija	Noun	ˈʋɑlehtelijɑ
valepuku	Noun	ˈʋɑleˌpːuku
valetaan	Verb	ˈvɑletɑːn
valetasku	Noun	ˈʋaleˌtːɑsku
valiini	Noun	ˈʋɑlːiːni
valinta	Noun	ˈʋɑlin̪t̪ɑ
valintakoe	Noun	ˈʋɑlintɑˌkoe(ʔ)
valita	Verb	ˈʋɑlitɑˣ
valitan	Verb	ˈvɑlitɑn
valitat	Verb	ˈvɑlitɑt
valittaa	Verb	ˈvɑlitːɑː(ʔ)
valittamaan	Verb	ˈvɑlitːɑmɑːn
valitus	Noun	ˈʋɑlit̪us
valjeta	Verb	ˈvɑljetɑ(ʔ)
vallan	Adverb	ˈʋɑlːɑn
vallata	Verb	ˈvɑlːɑtɑ(ʔ)
valli	Noun	ˈʋɑlːi
vallita	Verb	ˈʋɑlːitɑ
valloittaa	Verb	ˈvɑlːoitːɑː(ʔ)
valloittaja	Noun	ˈvɑlːoiˌtːɑjɑ
valmistella	Verb	ˈvɑlmistelːɑ(ʔ)
valmuska	Noun	ˈvɑl.mus.kɑ
valo	Noun	ˈvalo
valodiodi	Noun	ˈʋɑloˌdiodi
valoelin	Noun	ˈʋɑloˌelin
valosapeli	Noun	ˈʋaloˌsɑpeli
valssi	Noun	ˈʋɑlsːi
valtaa	Noun	ˈvɑltɑː(ʔ)
valtaistuin	Noun	ˈʋɑltɑˌistuin
valtimo	Noun	ˈʋɑltimo
valtuustoryhmä	Noun	ˈʋɑltuːstoˌryçmæ
valukouru	Noun	ˈʋɑluˌkouru
valuutanvaihto	Noun	ˈʋɑluːtɑnˌʋɑiç̞to
valvonta	Noun	ˈʋɑlʋontɑ
vamma	Noun	ˈʋɑmːɑ
vandalisoida	Verb	ˈvɑndɑliˌso̞idɑ(ʔ)
vangita	Verb	ˈʋɑŋːitɑˣ
vangitaan	Verb	ˈvɑŋːitɑːn
vangittu	Adjective	ˈʋɑŋːitːu
vanhempi	Adjective	ˈʋɑnɦe̞mpi
vanhuus	Noun	ˈʋɑnɦuːs
vanilja	Noun	ˈʋɑniljɑ
vanki	Noun	ˈʋɑŋki
vannasluu	Noun	ˈʋɑnːɑsˌluː
vanne	Noun	ˈʋɑnːe̞ˣ
vannoa	Verb	ˈʋɑnːoɑˣ
vannoi	Verb	ˈʋɑnːoi
vapa	Noun	ˈʋɑpɑ
vapaa	Adjective	ˈʋɑpɑː
vapaus	Noun	ˈʋɑpɑus
vapauttaa	Verb	ˈʋɑpɑutːɑː(ʔ)
vapautua	Verb	ˈvɑpɑutuɑ(ʔ)
vappu	Noun	ˈʋɑpːu
vappuaatto	Noun	ˈʋɑpːuˌɑːtːo
vara	Prefix	ˈvɑrɑ
varaa	Noun	ˈvɑrɑː
varaani	Noun	ˈʋɑrɑːni
varapuhemies	Noun	ˈʋɑrɑˌpuɦeˌmːies
varastaa	Verb	ˈvɑrɑstɑː(ʔ)
varasto	Noun	ˈʋɑrɑsto
varat	Noun	ˈʋɑrɑt
varata	Verb	ˈʋɑrɑt̪ɑ(ʔ)
varis	Noun	ˈʋɑris
varistaa	Verb	ˈvɑristɑː(ʔ)
varkailla	Noun	ˈvɑrkɑilːɑ
varmuuskopio	Noun	ˈʋɑrmuːsˌkopio
varoa	Verb	ˈvɑroɑ(ʔ)
varoittaa	Verb	ˈvɑroitːɑː(ʔ)
varojen	Noun	ˈʋɑrojen
varpaankynsi	Noun	ˈʋɑrpɑːnˌkynsi
varpunen	Noun	ˈʋɑrpune̞n
varpuspöllö	Noun	ˈʋɑrpusˌpø̞lːø̞
varsa	Noun	ˈʋɑrsɑ
varsi	Noun	ˈʋɑrsi
varsieväkala	Noun	ˈʋɑrsiˌeʋæˌkɑlɑ
vartija	Noun	ˈʋɑrtijɑ
varusmiespalvelus	Noun	ˈvɑrusmiesˌpɑlvelus
varvas	Noun	ˈʋɑrʋɑs
varvasastuja	Noun	ˈʋɑrʋɑsˌɑstujɑ
vasalli	Noun	ˈvɑsɑlːi
vasara	Noun	ˈʋɑsɑrɑ
vasen	Noun	ˈʋɑsen
vasikka	Noun	ˈʋɑsikːɑ
vasta	Adjective	ˈvasta
vastaa	Noun	ˈvɑstɑː
vastaaja	Noun	ˈvɑstɑːjɑ
vastaanotin	Noun	ˈʋɑstɑːnˌotin
vastaanotto	Noun	ˈʋɑstɑːnˌotːo
vastahakoinen	Adjective	ˈvɑstɑˌɦɑkoinen
vastaisuus	Noun	ˈʋɑst̪ɑisuːs
vastapuikea	Adjective	ˈʋɑstɑˌpuikeɑ
vastasyytös	Noun	ˈvɑstɑˌsyːtøs
vastata	Verb	ˈʋɑstɑtɑˣ
vastatuuli	Noun	ˈʋɑstɑˌtuːli
vaste	Adjective	ˈʋɑsteˣ
vastedes	Adverb	ˈʋɑstˈe̞de̞s
vastin	Noun	ˈʋɑstin
vastus	Noun	ˈʋɑstus
vastuu	Noun	ˈʋɑstuː
vati	Numeral	ˈʋɑti
vatsaevä	Noun	ˈʋɑt̪sɑˌe̞ʋæ
vatsatauti	Noun	ˈʋɑtsɑˌtɑuti
vatupassi	Noun	ˈʋɑt̪uˌpɑsːi
vauhti	Noun	ˈʋɑuhti
vauva	Noun	ˈʋɑu̯ʋɑ
vauvakutsut	Noun	ˈʋɑuʋːɑˌkutsut
vauvamainen	Adjective	ˈʋɑuʋːɑˌmɑinen
vedellä	Noun	ˈʋe̞de̞lːæ
vedenkeitin	Noun	ˈʋedenˌkeitin
vedonlyönti	Noun	ˈʋedonˌlyønti
vee	Noun	viː
vegaani	Noun	ˈʋeɡɑːni
vehka	Noun	ˈʋehkɑ
vehnä	Noun	ˈʋehnæ
vehnäleipä	Noun	ˈʋehnæˌleipæ
vei	Noun	ˈʋei
veisata	Verb	ˈveisata
veitsi	Noun	ˈʋe̞it̪si
vekkihame	Noun	ˈʋekːiˌxɑme(ʔ)
velho	Noun	ˈvelho
velhotar	Noun	ˈʋelɦotɑr
veli	Verb	ˈveli
velli	Noun	ˈʋelːi
velliä	Noun	ˈʋelːiæ
veloitus	Noun	ˈʋeloitus
velot	Verb	ˈʋe̞lo̞t̪
velvollisuus	Noun	ˈʋelʋolːisuːs
venata	Verb	ˈvenata(ʔ)
vene	Noun	ˈʋeneˣ
venyttää	Verb	ˈvenytːæː
venytys	Noun	ˈʋenytys
venähdys	Noun	ˈʋe̞næcdys
venäjänkielinen	Adjective	ˈʋenæjænˌkie̯linen
venäläisyys	Noun	ˈʋenæˌlæisyːs
vepsä	Noun	ˈʋepsæ
veranta	Noun	ˈʋerɑntɑ
verbi	Noun	ˈʋerbi
vereen	Noun	ˈvereːn
verenluovutus	Noun	ˈʋerenˌluoʋutus
verensokeri	Noun	ˈʋerenˌsokeri
verhiö	Noun	ˈʋe̞rç̞iø̞
veri	Noun	vɛˈɾi
verihiutale	Noun	ˈʋe̞riˌhiutɑle̞ˣ
verikoe	Noun	ˈʋe̞riˌko̞.e̞
verikosto	Noun	ˈveriˌkosto
verisesti	Adverb	ˈʋe̞rise̞stiˣ
verisuoni	Noun	ˈʋe̞riˌsuɔni
verkkokalvo	Noun	ˈʋerkːoˌkɑlʋo
verkkosiipinen	Noun	ˈʋerkːoˌsiːpinen
veronalainen	Adjective	ˈʋeronˌɑlɑinen
veronpalautus	Noun	ˈʋe̞ro̞nˌpɑlɑut̪us
veroparatiisi	Noun	ˈʋeroˌpɑrɑtiːsi
verrannollinen	Adjective	ˈʋerːɑnːolːinen
version	Noun	ˈvɝʒən
verstas	Noun	ˈʋerstɑs
vesa	Noun	ˈʋesɑ
vesi	Noun	ˈvesi
vesiekosysteemi	Noun	ˈʋesiˌekoˌsysteːmi
vesihöyry	Noun	ˈʋesiˌhøyry
vesikirppu	Noun	ˈʋesiˌkirpːu
vesiliirto	Noun	ˈʋesiˌliːrto
vesimeloni	Noun	ˈʋesiˌmeloni
vesimies	Noun	ˈʋesiˌmies
vesiputous	Noun	ˈʋesiˌputous
vesipöhö	Noun	ˈʋe̞siˌpø̞ɦø̞
vesistö	Noun	ˈʋe̞sistø̞
vesitiede	Noun	ˈʋe̞siˌt̪ie̞de̞ˣ
vesivaaka	Noun	ˈʋe̞siˌʋɑːkɑ
vesiveski	Noun	ˈʋesiˌʋeski
vessaharja	Noun	ˈʋe̞sːɑˌhɑrjɑ
vessapaperirulla	Noun	ˈʋesːɑˌpɑperiˌrulːɑ
veto	Noun	ˈviːtəʊ
vetoisuus	Noun	ˈʋetoisuːs
vetokoukku	Noun	ˈʋetoˌkou̯kːu
vetooikeus	Noun	ˈʋeto(ʔ)ˌoikeus
veturi	Verb	veˈturi
veturinkuljettaja	Noun	ˈʋeturinˌkuljetːɑjɑ
vety	Noun	ˈʋe̞t̪y
vie	Verb	vaɪ
viedä	Verb	ˈviedæ(ʔ)
viehe	Noun	ˈʋiehe(ʔ)
viekas	Adjective	ˈʋi͡e̞kɑs
viekoitella	Verb	ˈviekoitella
viekotella	Verb	ˈviekotella
viemäri	Noun	ˈʋie̞mæri
vientikielto	Noun	ˈʋientiˌkielto
vieras	Adjective	ˈʋierɑs
vieri	Noun	ˈʋieri
vieriä	Verb	ˈvieriæ
vierähtää	Verb	ˈʋie̞ræçt̪æː
viesti	Noun	ˈʋiesti
viestiketju	Noun	ˈʋiestiˌketju
vietellä	Verb	ˈvietelːæ(ʔ)
vieteri	Noun	ˈʋieteri
vietnamilainen	Adjective	ˈʋiet̪nɑmiˌlɑinen
viettelijätär	Noun	ˈʋietːeˌlijætær
viettiä	Noun	ˈʋietːiæ
viha	Noun	ˈʋihɑ
vihainen	Adjective	ˈʋihɑinen
vihaisesti	Adverb	ˈʋiɦɑise̞sti
vihamies	Noun	ˈʋihɑˌmies
vihanlietsoja	Noun	ˈʋiɦɑnˌlietsojɑ
vihanneskrassi	Noun	ˈʋiɦɑnːesˌkrɑsːi
vihata	Verb	ˈvihɑtɑ(ʔ)
viheltää	Verb	ˈʋiɦe̞ltæːˣ
viherkaihi	Noun	ˈʋiɦerˌkɑiɦi
viherpeippo	Noun	ˈʋiɦerˌpeipːo
vihervarpunen	Noun	ˈʋiɦerˌʋɑrpunen
vihi	Noun	ˈʋiɦi
vihkiä	Verb	ˈʋiçki.æˣ
vihko	Noun	ˈʋiçko̞
vihne	Noun	ˈʋiç̞ne̞ˣ
vihoissaan	Adverb	ˈvihoisːɑːn
vihoitella	Verb	ˈvihoitelːɑ(ʔ)
vihoitellen	Verb	ˈvihoitelːen
vihreä	Adjective	ˈʋihreæ
vihta	Noun	ˈʋiçtɑ
viidakko	Noun	ˈʋiːdɑkːo
viides	Adjective	ˈʋiːde̞s
viihde	Noun	ˈʋiːç̞de̞ˣ
viikate	Noun	ˈʋiːkɑt̪eˣ
viikko	Noun	ˈʋiːkːo
viikset	Noun	ˈʋiːkset
viiksi	Noun	ˈʋiːksi
viila	Noun	ˈʋiːlɑ
viilata	Verb	ˈʋiːlɑt̪ɑˣ
viili	Noun	ˈʋiːli
viiltää	Verb	ˈʋiːltæː(ʔ)
viime	Adjective	ˈviːme
viimeistä	Adjective	ˈviːmeistæ
viinettä	Noun	ˈʋiːne̞t̪æ
viini	Noun	ˈʋiːni
viinirypäle	Noun	ˈʋiːniˌrypæle(ʔ)
viipyä	Verb	ˈviːpyæ(ʔ)
viiru	Noun	ˈʋiːru
viisas	Adjective	ˈʋiːsɑs
viisastella	Verb	ˈviːsɑstelːɑ(ʔ)
viisastua	Verb	ˈviːsɑstuɑ(ʔ)
viisi	Numeral	ˈʋiːsi
viisikulmio	Noun	ˈʋiːsiˌkulmio
viisitoista	Numeral	ˈʋiːsiˌtoi̯stɑ
viistoperä	Noun	ˈʋiːstoˌperæ
viitata	Verb	ˈviːtɑtɑ(ʔ)
viiva	Noun	ˈʋiːʋɑ
viivain	Noun	ˈʋiːʋɑin
viive	Noun	ˈʋiːʋeˣ
viivästyskorko	Noun	ˈʋiːʋæstysˌkorko
vika	Noun	ˈʋikɑ
vikitellä	Verb	ˈvikitelːæ(ʔ)
vilja	Verb	ˈʋiljɑ
viljely	Noun	ˈʋiljely
vilkku	Noun	ˈʋilkːu
vilkkua	Verb	ˈʋilkːuɑ(ʔ)
villaapina	Noun	ˈʋilːɑʔˌɑpinɑ
villakoiranydin	Phrase	ˈʋilːɑˌkoirɑn ˈydin
villi	Noun	ˈʋilːi
vilppaus	Noun	ˈʋilpːɑu̯s
vinkki	Noun	ˈʋiŋkːi
vinoneliö	Noun	ˈʋino̞ˌne̞liø̞
vinoviiva	Noun	ˈʋino̞ˌʋiːʋɑ
vintti	Noun	ˈʋintːi
violetti	Adjective	ˈʋioletːi
vipa	Adjective	ˈʋipɑ
vipu	Verb	ˈʋipu
virasto	Noun	ˈʋirɑsto
virheravitsemus	Noun	ˈʋirhe̞ˌrɑʋitsemus
virittää	Verb	ˈʋiritˑtæː
virka	Adjective	ˈvirkɑ
virkamies	Noun	ˈʋirkɑˌmies
virke	Verb	ˈʋirke̞ˣ
virkkaa	Verb	ˈvirkːɑː(ʔ)
virna	Noun	ˈʋirnɑ
virnaperhonen	Noun	ˈʋirnɑˌperhonen
virnuilla	Verb	ˈvirːnu̞ilːaˣ
virolainen	Noun	ˈviroˌlɑinen
virota	Verb	ˈʋirotɑˣ
virpi	Noun	ˈʋirpi
virsta	Noun	ˈʋirstɑ
virta	Noun	ˈʋirtɑ
virtsaputki	Noun	ˈʋirtsɑˌputki
virtsata	Verb	ˈvirtsɑtɑ(ʔ)
virtsatietulehdus	Noun	ˈʋirtsɑtie̯ˌtulehdus
virus	Noun	ˈvaɪɹəs
viserrys	Noun	ˈʋiserːys
viskata	Verb	ˈviskata
viskoosi	Noun	ˈʋiskoːsi
vispikerma	Noun	ˈʋispiˌkermɑ
vispilä	Noun	ˈʋispilæ
vita	Noun	ˈʋitɑ
vitaalielin	Noun	ˈʋitɑːliˌelin
vitamiini	Noun	ˈʋitɑmiːni
vitaminoida	Verb	ˈʋitɑmiˌnoidɑ
vitkalaukaisin	Noun	ˈʋitkɑˌlɑukɑisin
vitriini	Noun	ˈʋit̪riːni
vitsi	Noun	ˈʋitsi
vittu	Noun	ˈʋitːu
vittuilla	Verb	ˈʋitːuilːɑˣ
vitun	Adverb	ˈʋit̪un
viuhko	Noun	ˈʋiuxko̞
vohveli	Noun	ˈʋohʋeli
voi	Pronoun	βoi
voida	Verb	ˈʋo̞idɑˣ
voidaan	Verb	ˈvoidɑːn
voide	Adjective	ˈʋo̞ide̞ˣ
voidella	Verb	ˈʋoi̯delːɑˣ
voihke	Noun	ˈʋoihke(ʔ)
voikukka	Noun	ˈʋoiˌkukːɑ
voima	Noun	ˈʋoi̯mɑ
voimala	Noun	ˈʋoimɑlɑ
voimamies	Noun	ˈʋoimɑˌmies
voimanlähde	Noun	ˈʋoimɑnˌlæhde(ʔ)
voimasana	Noun	ˈʋoimɑˌsɑnɑ
voimattomuus	Noun	ˈʋoimɑtːomuːs
voisi	Noun	ˈʋo̞isi
voisimme	Verb	ˈvoisimme
voisin	Verb	ˈvoisin
voisitte	Verb	ˈvoisitte
voisivat	Verb	ˈvoisivat
voitelu	Noun	ˈʋoitelu
voittaa	Verb	ˈʋoitːɑː(ʔ)
voittaja	Noun	ˈʋoitːɑjɑ
vokaali	Noun	ˈʋokɑːli
volapük	Noun	ˈʋolɑpyk
volframi	Noun	ˈʋolfrɑmi
voro	Noun	ˈʋoro
vulgaari	Adjective	ˈʋulɡɑːri
vuode	Noun	ˈʋuode(ʔ)
vuodenaika	Noun	ˈʋuo̯denˌɑi̯kɑ
vuohenjuusto	Noun	ˈʋuoɦenˌjuːsto
vuohinen	Noun	ˈʋuoɦinen
vuokaavio	Noun	ˈʋuoˌkɑːʋio
vuokra	Noun	ˈʋuokrɑ
vuokraasunto	Noun	ˈʋuokrɑʔˌɑsunto
vuokralainen	Noun	ˈʋuokrɑlɑinen
vuokranantaja	Noun	ˈʋuokrɑnˌɑntɑjɑ
vuoksi	Noun	ˈʋuoksi
vuolla	Noun	ˈʋuɔlːɑ
vuollen	Verb	vuolːen
vuonna	Adverb	ˈʋuɔnːɑ
vuori	Noun	ˈʋuo̯ri
vuorineuvos	Noun	ˈʋuoriˌneuʋos
vuoristorata	Noun	ˈʋuoristoˌrɑtɑ
vuorokausi	Noun	ˈʋuo̯roˌkɑu̯si
vuosi	Noun	ˈʋuo̯si
vuosia	Noun	ˈʋuosiɑ
vuosimiljardi	Noun	ˈʋuo̯siˌmiljɑrdi
vuosimiljoona	Noun	ˈʋuo̯siˌmiljoːnɑ
vuosisata	Noun	ˈʋuo̯siˌsɑtɑ
vuosituhat	Noun	ˈʋuo̯siˌtuhɑt
vyyhti	Noun	ˈʋyːçt̪i
vyöhykeraja	Noun	ˈʋyøɦykeˌrɑjɑ
vyötärö	Noun	ˈʋyøtærø
väestönlaskenta	Noun	ˈvæstønˌlɑskentɑ
väestönsuoja	Noun	ˈvæestønˌsuojɑ
väheksyä	Verb	ˈvæheksyæ(ʔ)
vähentää	Verb	ˈvæhentæː(ʔ)
vähätellä	Verb	ˈvæhætelːæ(ʔ)
väijyä	Verb	ˈvæijyæ(ʔ)
väistetään	Verb	ˈvæistetæːn
väitöskirja	Noun	ˈʋæitøsˌkirjɑ
väkevä	Adjective	ˈʋækeʋæ
väkisinmaata	Verb	ˈvækisimˌːɑːtɑˣ
väkisinmakaaminen	Noun	ˈvækisiˌmːɑkɑːminen
väkivalta	Noun	ˈvækiˌvɑltɑ
väliilmansuunta	Noun	ˈʋæli(ʔ)ˌilmɑnˌsuːntɑ
välimerentaateli	Noun	ˈʋæliˌmerenˌtɑːteli
välittyä	Verb	ˈvælitːyæ(ʔ)
välittämään	Verb	ˈvælitːæmæːn
välittää	Verb	ˈvælitːæː(ʔ)
välitä	Verb	ˈvælitæ(ʔ)
välitän	Verb	ˈvælitæn
välität	Verb	ˈvælitæt
välivuosi	Noun	ˈʋæliˌʋuo̯si
välkkyä	Verb	ˈʋælkːyæ(ʔ)
vältellä	Verb	ˈvæltelːæ(ʔ)
välttää	Verb	ˈvæltːæː(ʔ)
värisokeus	Noun	ˈʋæriˌsokeus
värkätä	Verb	ˈʋærkætæˣ
värttinä	Noun	ˈʋærtːinæ
väsymys	Noun	ˈʋæsymys
vävy	Noun	ˈʋæʋy
väylinki	Noun	ˈʋæyliŋki
vääjäämättä	Adverb	ˈʋæːjæːˌmætːæ
vääntää	Verb	ˈʋæːntæːˣ
vääntäärautalangasta	Verb	ˈʋæːntæːˣ ˈrɑutɑˌlɑŋŋɑstɑ
vääpeli	Noun	ˈʋæːpeli
väärentää	Verb	ˈʋæːrentæː(ʔ)
väärin	Adverb	ˈʋæːrin
väärinkäsitys	Noun	ˈʋæːrinˌkæsit̪ys
väärinkäyttö	Noun	ˈʋæːrinˌkæytːø
väärä	Adjective	ˈʋæːræ
vääräuskoinen	Noun	ˈʋæːræˌuskoinen
yttrium	Noun	ˈɪ.tɹi.əm
yy	Noun	ˈyː
yö	Noun	ˈyø̯
yöaika	Noun	ˈyø̯ˌɑi̯kɑ
yöeläin	Noun	ˈyø̯ˌelɑi̯n
yöhyt	Noun	ˈyø̯hyt
yökkönen	Noun	ˈyø̯kːønen
yöperhonen	Noun	ˈyø̯ˌperhonen
yöpuku	Noun	ˈyø̯ˌpuku
yösydän	Noun	ˈyø̯ˌsydæn
yötyö	Noun	ˈyø̯ˌtyø̯
yötönyö	Noun	ˈyø̯tøn yø̯
šaketti	Noun	ˈʃɑketːi
šakki	Noun	ˈʃɑkːi
šakkimatti	Noun	ˈʃɑkːiˌmɑtːi
šamaani	Noun	ˈʃɑmɑːni
šamanismi	Noun	ˈʃɑmɑnismi
šeikki	Noun	ˈʃe͡ikːi
šekki	Noun	ˈʃekːi
šiia	Noun	ˈʃiːɑ
šikaani	Noun	ˈʃikɑːni
šillinki	Noun	ˈʃilːiŋki
šuntti	Noun	ˈʃuntːi
