a	ə
aalborski	ɔlˈbɔr.skʲi
abaka	a.baˈka
abakus	abakos
abazja	aˈbaz.ja
abażur	aˈba.ʐur
abchascy	apˈxas.t͡sɨ
abchaski	apˈxas.kʲi
abdykacja	ab.dɨˈkat͡s.ja
abecadło	a.bɛˈt͡sa.dwɔ
abiogeneza	a.bʲɔ.ɡɛˈnɛ.za
abisyńscy	a.bʲiˈsɨɲ.st͡sɨ
abisyński	a.bʲiˈsɨɲ.skʲi
abiturient	a.bʲiˈtu.rʲɛnt
ablacja	abˈlat͡s.ja
ablatyw	abˈla.tɨf
abnegat	abˈnɛ.ɡat
abo	ˈæb.əʉ
abonament	a.bɔˈna.mɛnt
abonent	aˈbɔ.nɛnt
abonowana	a.bɔ.nɔˈva.na
abonowane	a.bɔ.nɔˈva.nɛ
abonowanego	a.bɔ.nɔ.vaˈnɛ.ɡɔ
abonowanej	a.bɔ.nɔˈva.nɛj
abonowanemu	a.bɔ.nɔ.vaˈnɛ.mu
abonowani	a.bɔ.nɔˈva.ɲi
abonowany	a.bɔ.nɔˈva.nɨ
abonowanych	a.bɔ.nɔˈva.nɨx
abonowanym	a.bɔ.nɔˈva.nɨm
abonowanymi	a.bɔ.nɔ.vaˈnɨ.mʲi
abonowaną	a.bɔ.nɔˈva.nɔ̃
abonować	a.bɔˈnɔ.vat͡ɕ
abonujące	a.bɔ.nuˈjɔn.t͡sɛ
abonującego	a.bɔ.nu.jɔnˈt͡sɛ.ɡɔ
abonującej	a.bɔ.nuˈjɔn.t͡sɛj
abonującemu	a.bɔ.nu.jɔnˈt͡sɛ.mu
abonujący	a.bɔ.nuˈjɔn.t͡sɨ
abonujących	a.bɔ.nuˈjɔn.t͡sɨx
abonującym	a.bɔ.nuˈjɔn.t͡sɨm
abonującymi	a.bɔ.nu.jɔnˈt͡sɨ.mʲi
abonującą	a.bɔ.nuˈjɔn.t͡sɔ̃
aborcja	aˈbɔr.t͡sja
absolutnie	ap.sɔˈlut.ɲɛ
absolutny	ap.sɔˈlut.nɨ
absolutyzm	ap.sɔˈlu.tɨzm
absolwent	apˈsɔl.vɛnt
absolwentka	ap.sɔlˈvɛn.tka
absorbować	ap.sɔrˈbɔ.vat͡ɕ
absorpcja	apˈsɔr.pt͡sja
abstrahować	ap.straˈxɔ.vat͡ɕ
abstrakcja	apˈstrak.t͡sja
abstynencja	ap.stɨˈnɛn.t͡sja
abstynent	apˈstɨ.nɛnt
absurd	əbˈsɜːd
absurdalnie	ap.surˈdal.ɲɛ
absurdalniej	ap.surˈdal.ɲɛj
absurdalniejszy	ap.sur.dalˈɲɛj.ʂɨ
absurdalny	ap.surˈdal.nɨ
absurdyzm	apˈsur.dɨzm
absynt	ˈap.sɨnt
aby	əˈbaɪ
acetamid	a.t͡sɛˈta.mʲit
aceton	ˈɒt͡sɛton
acetylen	a.t͡sɛˈtɨ.lɛn
achromatopsja	a.xrɔ.maˈtɔp.sja
aczkolwiek	at͡ʂˈkɔl.vʲɛk
adapter	əˈdaptə
adekwatnie	a.dɛˈkfat.ɲɛ
adekwatniej	a.dɛˈkfat.ɲɛj
adekwatniejszy	a.dɛ.kfatˈɲɛj.ʂɨ
adekwatny	a.dɛˈkfat.nɨ
adept	əˈdɛpt
adiutant	adˈju.tant
administracja	ad.mʲi.ɲiˈstrat͡s.ja
administrator	ədˈmɪnɪstɹeɪtə
administratorka	ad.mʲi.ɲi.straˈtɔr.ka
adopcja	aˈdɔp.t͡sja
adopcyj	aˈdɔp.t͡sɨj
adoracja	a.dɔˈrat͡s.ja
adrenalina	a.drɛ.naˈlʲi.na
adres	aːˈdrɛs
adresat	aˈdrɛ.sat
adresatka	a.drɛˈsat.ka
adresu	aˈdrɛ.su
adwent	ˈad.vɛnt
adwersarz	adˈvɛr.saʂ
adwokat	adˈvɔ.kat
adwokata	ad.vɔˈka.ta
adwokatdiabła	adˈvɔ.kat ˈdjab.la
adwokatka	ad.vɔˈkat.ka
adygejski	ad̪ɨˈɡɛjs̪ʲci
aerostat	a.ɛˈrɔ.stat
afera	aˈfɛ.ra
afgańscy	afˈɡaɲ.st͡sɨ
afgański	avˈɡaɲ.skʲi
afiks	ˈa.fʲiks
afirmacja	a.fʲirˈmat͡s.ja
aforyzm	aˈfɔ.rɨzm
afrodyzjak	a.frɔˈdɨz.jak
afrykanerski	a.frɨ.kaˈnɛr.skʲi
afrykański	a.frɨˈkaɲ.skʲi
agat	ˈaɡət̪ˠ
agawa	aˈɡa.va
agencjatowarzyska	aˈɡɛn.t͡sja tɔ.vaˈʐɨ.ska
agenta	aˈɡɛn.ta
agentura	a.ɡɛnˈtu.ra
agentów	aˈɡɛn.tuf
aglomeracja	aɡ.lɔ.mɛˈrat͡s.ja
aglutynacyjny	aɡ.lu.tɨ.naˈt͡sɨj.nɨ
agnostycyzm	aɡ.nɔˈstɨ.t͡sɨzm
agnostyczny	aɡ.nɔˈstɨt͡ʂ.nɨ
agnostyk	aɡˈnɔ.stɨk
agora	ˈæ.ɡə.ɹə
agorafobia	ˈɑɡorɑfobiɑ
agrafka	aˈɡraf.ka
agregat	aˈɡrɛ.ɡat
agregatprądotwórczy	aˈɡrɛ.ɡat prɔn.dɔˈtfur.t͡ʂɨ
agresja	aˈɡrɛs.ja
agrest	ˈa.ɡrɛst
agresywny	a.ɡrɛˈsɨv.nɨ
agronomia	a.ɡrɔˈnɔ.mʲa
aha	æhæ
aikido	aɪˈkiːdəʊ
akacja	aˈkat͡s.ja
akademia	a.kaˈdɛ.mʲa
akademicki	a.ka.dɛˈmʲit͡s.kʲi
akademik	a.kaˈdɛ.mʲik
akapit	aˈka.pʲit
akcelerometr	ak.t͡sɛ.lɛˈrɔ.mɛtr
akcent	ˈak.t͡sɛnt
akcja	ˈak.t͡sja
akcji	ˈak.t͡sji
akcjonariusz	ak.t͡sjɔˈna.rʲuʂ
akomodacja	a.kɔ.mɔˈdat͡s.ja
akordeon	a.kɔrˈdɛ.ɔn
akordeonista	a.kɔr.dɛ.ɔˈɲi.sta
akordeonistka	a.kɔr.dɛ.ɔˈɲi.stka
akrobata	ˈɒkrobɒtɒ
akrobatka	a.krɔˈbat.ka
akromegalia	a.krɔ.mɛˈɡa.lʲa
akromegalie	a.krɔ.mɛˈɡa.lʲɛ
akronim	aˈkrɔ.ɲim
akropol	aˈkrɔ.pɔl
aksamit	akˈsa.mʲit
aksjomat	akˈsjɔ.mat
akson	ˈak.sɔn
akt	ˈɒkt
aktor	ˈak.tɔr
aktorka	akˈtɔr.ka
aktorzy	akˈtɔ.ʐɨ
aktrozpaczy	akt rɔˈspa.t͡ʂɨ
aktualizacja	ak.tu.a.lʲiˈzat͡s.ja
aktualnie	ak.tuˈal.ɲɛ
aktualniejszy	ak.tu.alˈɲɛj.ʂɨ
aktualny	ak.tuˈal.nɨ
aktyn	ˈak.tɨn
aktywacja	ak.tɨˈvat͡s.ja
aktywista	ak.tɨˈvʲi.sta
aktywistka	ak.tɨˈvʲi.stka
aktywniejszy	ak.tɨvˈɲɛj.ʂɨ
aktywny	akˈtɨv.nɨ
auwasMurzynówbiją	a u vas muˈʐɨ.nuf ˈbʲi.jɔ̃
aświstaksiedziizawijajewtesreberka	a ˈɕfʲi.stak ˈɕɛ.d͡ʑi i zaˈvʲi.ja jɛ ftɛ srɛˈbɛr.ka
baba	baba
babci	ˈbap.t͡ɕi
babcia	ˈbap.t͡ɕa
babciny	bapˈt͡ɕi.nɨ
babciu	ˈbap.t͡ɕu
babeczka	baˈbɛt͡ʂ.ka
babielato	ˈba.bʲɛ ˈla.tɔ
babiloński	ba.bʲiˈlɔɲ.skʲi
babka	ˈbapka
babunia	baˈbu.ɲa
babyzdziadembrakuje	ˈba.bɨ ˈʑd͡ʑa.dɛm braˈku.jɛ
bachor	ˈba.xɔr
baczność	ˈbat͡ʂ.nɔɕt͡ɕ
bacówka	baˈt͡suf.ka
bad	bæd
badacz	ˈba.dat͡ʂ
badania	baˈda.ɲa
badanie	baˈda.ɲɛ
badać	ˈba.dat͡ɕ
badań	ˈba.daɲ
badyl	ˈba.dɨl
badziewie	baˈd͡ʑɛ.vʲɛ
bagatela	ba.ɡaˈtɛ.la
bagaż	ˈba.ɡaʂ
bagażnik	baˈɡaʐ.ɲik
bagietka	baˈɡʲɛt.ka
bagnet	ˈbaɡ.nɛt
bagno	ˈba.ɲo
bajanizm	baˈja.ɲizm
bajać	ˈba.jat͡ɕ
bajgiel	ˈbaj.ɡʲɛl
bajka	ˈbaj.ka
bajońskiesumy	baˈjɔɲ.skʲɛ ˈsu.mɨ
bajt	ˈbɒjt
bajta	ˈbaj.ta
bak	bɑk
bakałarz	baˈka.waʂ
bakburta	bakˈbur.ta
baks	baks
bakteria	bakˈtɛ.rʲa
bakteriobójczy	bak.tɛ.rʲɔˈbuj.t͡ʂɨ
bakteriofag	bak.tɛˈrʲɔ.fak
bakteryjny	bak.tɛˈrɨj.nɨ
bakłażan	baˈkwa.ʐan
bal	bɑl
balast	ˈba.last
baldachim	balˈda.xʲim
balet	ˈba.lɛt
balia	ˈba.lʲa
balista	balɪsta
balkon	balkɔnɡ
balsam	ˈbɔːlsəm
balsamować	bal.saˈmɔ.vat͡ɕ
balustrada	ba.luˈstra.da
bambus	ˈpampʏs
bambusowy	bam.buˈsɔ.vɨ
ban	bæn
banalniejszy	ba.nalˈɲɛj.ʂɨ
banalny	baˈnal.nɨ
banan	ba.naːn
bananowy	ba.naˈnɔ.vɨ
banda	ˈban.də
bandaż	ˈban.daʂ
bandera	banˈdɛ.ra
banderowski	ban.dɛˈrɔf.skʲi
bandyta	banˈdɨ.ta
banialuki	ba.ɲaˈlu.kʲi
banicja	baˈɲit͡s.ja
banita	baˈɲi.ta
bank	bæŋk
banki	ˈbá.ᵑki
bankiet	ˈban.kʲɛt
banknot	ˈban.knɔt
bankomat	ˈbaŋkomat
bankructwo	banˈkrut͡s.tfɔ
bankrut	ˈban.krut
bankrutując	ban.kruˈtu.jɔnt͡s
bankrutujący	ban.kru.tuˈjɔn.t͡sɨ
bar	bɑː
barabanda	ba.raˈban.da
barachło	baraxˈwɔ
baran	ˈbaran
baranek	baˈra.nɛk
baranina	ba.raˈɲi.na
barbarzyńca	bar.baˈʐɨɲ.t͡sa
barbarzyństwo	bar.baˈʐɨɲ.stfɔ
bardak	ˈbar.dak
bardziej	ˈbar.d͡ʑɛj
bardzo	ˈbar.d͡zɔ
bareizm	baˈrɛ.izm
barion	ˈbarjɔn̪
bark	bɑːk
barka	ˈbɒrkɒ
barman	ˈbɑːmən
barograf	baˈrɔ.ɡraf
barogram	baˈrɔ.ɡram
barok	ˈba.rɔk
barokowy	ba.rɔˈkɔ.vɨ
barometr	baˈrɔmɛtr
barszcz	barʂt͡ʂ
barć	bart͡ɕ
barłóg	ˈba.rwuk
baćsię	ˈbat͡ɕ.ɕɛ
bałagan	baˈwa.ɡan
bałałajka	ba.waˈwaj.ka
bałkański	bawˈkaɲ.skʲi
bałtosłowiański	ˌbaw.tɔ.swɔˈvʲaɲ.ski
bałtycki	bawˈtɨt͡s.kʲi
bałwan	ˈbaw.van
bałwochwalca	baw.vɔˈxfal.t͡sa
bałwochwalstwo	baw.vɔˈxfal.stfɔ
bańka	ˈbaɲ.ka
cacko	ˈt͡sat͡s.kɔ
cadyk	ˈt͡sa.dɨk
cal	ˈkal
cali	ˈt͡sa.lʲi
camembert	ˈkɑmembæːr
cap	kæp
car	kɑː
caryca	t͡saˈrɨ.t͡sa
casting	kas.tiŋ
catering	ˈkeɪtəɹɪŋ
cała	ˈt͡sa.wa
całe	ˈt͡sa.wɛ
całka	ˈt͡saw.ka
całkaoznaczona	ˈt͡saw.ka ɔz.naˈt͡ʂɔ.na
całkiem	ˈt͡saw.kʲɛm
całkowanie	t͡saw.kɔˈva.ɲɛ
całkowicie	t͡saw.kɔˈvʲi.t͡ɕɛ
całkowity	t͡saw.kɔˈvʲi.tɨ
cało	ˈt͡sa.wɔ
całopalenie	t͡sa.wɔ.paˈlɛ.ɲɛ
całować	t͡saˈwɔ.vat͡ɕ
całość	ˈt͡sa.wɔɕt͡ɕ
całując	t͡saˈwu.jɔnt͡s
całujący	t͡sa.wuˈjɔn.t͡sɨ
całun	ˈt͡sa.wun
cały	ˈt͡sa.wɨ
całym	ˈt͡sa.wɨm
całą	ˈt͡sa.wɔ̃
ceber	ˈt͡sɛ.bɛr
cebrzyk	ˈt͡sɛb.ʐɨk
cebula	t͡sɛˈbu.la
cebulica	t͡sɛ.buˈlʲi.t͡sa
cebulka	t͡sɛˈbul.ka
cebulowy	t͡sɛ.buˈlɔ.vɨ
cech	t͡sɛx
cecha	ˈt͡sɛ.xa
cedrowy	t͡sɛˈdrɔ.vɨ
cedzak	ˈt͡sɛ.d͡zak
cedzidło	t͡sɛˈd͡ʑi.dwɔ
cedzić	ˈt͡sɛ.d͡ʑit͡ɕ
cegielnik	t͡sɛˈɡʲɛl.ɲik
ceglany	t͡sɛɡˈla.nɨ
ceglarz	ˈt͡sɛɡ.laʂ
ceglasty	t͡sɛɡˈla.stɨ
cegła	ˈt͡sɛ.ɡwa
cegłówka	t͡sɛˈɡwuf.ka
cel	sɛl
cela	sə.la
celibat	t͡sɛˈlʲi.bat
celnik	ˈt͡sɛl.ɲik
celny	ˈt͡sɛl.nɨ
celofan	t͡sɛˈlɔ.fan
celownik	t͡sɛˈlɔv.ɲik
celtyccy	t͡sɛlˈtɨt͡s.t͡sɨ
celtycka	t͡sɛlˈtɨt͡s.ka
celtycki	t͡sɛlˈtɨt͡s.kʲi
celtyckie	t͡sɛlˈtɨt͡s.kʲɛ
cement	səˈmɛnt
cena	ˈt͡sɛna
cenić	ˈt͡sɛ.ɲit͡ɕ
cennik	ˈt͡sɛɲ.ɲik
cent	sɛnt
centralizm	t͡sɛnˈtra.lʲizm
centralny	t͡sɛnˈtral.nɨ
centrum	ˈt͡sɛntrum
centymetr	t͡sɛnˈtɨ.mɛtr
centów	ˈt͡sɛn.tuf
cenę	ˈt͡sɛ.nɛ
cep	sɛp
cer	tsɛːr
cera	ˈtʃera
ceramiczny	t͡sɛ.raˈmʲit͡ʂ.nɨ
ceramika	t͡sɛ.raˈmʲi.ka
ceremonia	t͡sɛ.rɛˈmɔ.ɲa
cerkiew	ˈt͡sɛr.kʲɛf
certyfikat	t͡sɛr.tɨˈfʲi.kat
cesarka	t͡sɛˈsar.ka
cesarski	t͡sɛˈsar.skʲi
cesarskiecięcie	t͡sɛˈsar.skʲɛ ˈt͡ɕɛɲ.t͡ɕɛ
cesarstwo	t͡sɛˈsar.stfɔ
cesarz	ˈt͡sɛ.saʂ
cesarzowa	t͡sɛ.saˈʐɔ.va
cet	sɛt‿
cewa	ˈt͡sɛ.va
cewka	ˈt͡sɛf.ka
cewkamoczowa	ˈt͡sɛf.ka mɔˈt͡ʂɔ.va
cewnik	ˈt͡sɛv.ɲik
cez	t͡sɛs
cezaropapizm	t͡sɛ.za.rɔˈpa.pʲizm
chachoł	ˈxa.xɔw
chadzanie	xaˈd͡za.ɲɛ
chadzać	ˈxa.d͡zat͡ɕ
chadzałam	xaˈd͡za.wam
chadzałaś	xaˈd͡za.waɕ
chadzałem	xaˈd͡za.wɛm
chadzałeś	xaˈd͡za.wɛɕ
cham	kæm
chan	xan̪ˠ
chaos	ˈkeɪ.ɒs
chaotyczny	xa.ɔˈtɨt͡ʂ.nɨ
chapać	ˈxa.pat͡ɕ
charakter	xaˈrak.tɛr
charkać	ˈxar.kat͡ɕ
chart	tʃɑɹt
charytatywny	xa.rɨ.taˈtɨv.nɨ
chata	ˈxɑt̪ˠə
chatka	ˈxat.ka
chaus	ˈkeɪ.ʌs
chałka	ˈxaw.ka
chałupa	xaˈwu.pa
chałwa	ˈxaw.va
chce	xt͡sɛ
chcecie	ˈxt͡sɛ.t͡ɕɛ
chcemy	ˈxt͡sɛ.mɨ
chcesz	xt͡sɛʂ
chciał	xt͡ɕaw
chciała	ˈxt͡ɕa.wa
chciałabym	ˈxt͡ɕawabɨm
chciałam	ˈxt͡ɕa.wam
chciałbym	ˈxt͡ɕaw.bɨm
chciałem	ˈxt͡ɕa.wɛm
chciałeś	ˈxt͡ɕa.wɛɕ
chcieć	xt͡ɕɛt͡ɕ
chciwość	ˈxt͡ɕi.vɔɕt͡ɕ
chciwszy	ˈxt͡ɕif.ʂɨ
chciwy	ˈxt͡ɕi.vɨ
chcą	xt͡sɔ̃
chcąc	xt͡sɔnt͡s
chcący	ˈxt͡sɔn.t͡sɨ
chcę	xt͡sɛ
cheeseburger	t͡ʂizˈbur.ɡɛr
chemia	ˈkʰeː.mi.a
chemiaorganiczna	ˈxɛ.mʲa ɔr.ɡaˈɲit͡ʂ.na
chemiczny	xɛˈmʲit͡ʂ.nɨ
chemik	ˈxɛmɪk
chełpićsię	ˈxɛw.pʲit͡ɕ ɕɛ
chichotać	xʲiˈxɔ.tat͡ɕ
chinina	xʲiˈɲi.na
chinol	ˈxʲi.nɔl
chips	tʃɪps
chirurg	ʃiˈrʏr(ə)x
chirurgia	kʰiːˈrur.ɡi.a
chirurgiaestetyczna	xʲiˈrur.ɡʲa ɛ.stɛˈtɨt͡ʂ.na
chirurgiakosmetyczna	xʲiˈrur.ɡʲa kɔs.mɛˈtɨt͡ʂ.na
chirurgiaplastyczna	xʲiˈrur.ɡʲa plaˈstɨt͡ʂ.na
chirurgiczny	xʲi.rurˈɡʲit͡ʂ.nɨ
chińczyk	ˈxʲiɲ.t͡ʂɨk
chińscy	ˈxʲiɲ.st͡sɨ
chiński	ˈxʲiɲ.skʲi
chińszczyzna	xʲiɲˈʂt͡ʂɨz.na
chlap	xlap
chlać	xlat͡ɕ
chleb	xlɛp
chlew	xlɛf
chlor	xloːr
chlorek	ˈxlɔ.rɛk
chloroform	ˈklɔːɹə(ʊ)̩fɔː(ɹ)m
chędogi	xɛnˈdɔ.ɡʲi
chętnie	ˈxɛn.tɲɛ
chęć	xɛɲt͡ɕ
cętka	ˈt͡sɛn.tka
da	də
dach	dax
dachowiec	daˈxɔ.vʲɛt͡s
dachowy	daˈxɔ.vɨ
dachu	ˈda.xu
dachy	ˈda.xɨ
dachówka	daˈxuf.ka
dacza	ˈda.t͡ʂa
daj	daj
dajcie	d̪ajt͡ɕɛ
dajecie	daˈjɛ.t͡ɕɛ
dajemy	daˈjɛ.mɨ
dają	ˈda.jɔ̃
daktyl	ˈdak.tɨl
dal	ˈdɒl
dalecy	daˈlɛt͡sɨ
dalej	ˈdalej
daleka	daˈlɛ.ka
daleki	daˈlɛ.kʲi
dalekie	daˈlɛ.kʲɛ
daleko	ˈdalɛko
dali	ˈdalʲi
dalia	ˈdɒliʲɒ
dalmatyńczyk	dal.maˈtɨɲ.t͡ʂɨk
dalmatyński	dal.maˈtɨɲ.skʲi
dalszy	ˈdal.ʂɨ
daltonizm	dalˈtɔ.ɲizm
dam	dæm
dama	ˈda.mə
damy	ˈda.mɨ
dandys	ˈdan.dɨs
dane	ˈdanɛ
dania	ˈda.ɲa
danie	ˈda.ɲɛ
daniel	ˈdænjəl
danina	daˈɲi.na
dantejski	danˈtɛj.skʲi
dantejskiesceny	danˈtɛj.skʲɛ ˈst͡sɛ.nɨ
dany	ˈdanɪ
darach	ˈdarax
darcie	ˈdar.t͡ɕɛ
daremny	daˈrɛm.nɨ
darli	ˈdar.lʲi
darmo	ˈdar.mɔ
darmowy	darˈmɔ.vɨ
darmsztadt	ˈdar.mʂtat
darowizna	da.rɔˈviz.na
daru	ˈdɒru
darwinista	ˈdɒrviniʃtɒ
dary	ˈdarɨ
darń	darɲ
dasz	daʂ
daszek	ˈd̪aʂɛk
data	ˈdeɪtə
dawaj	ˈdawaj
dawać	ˈda.vat͡ɕ
dawaćdupy	ˈda.vat͡ɕ ˈdu.pɨ
dawca	ˈdaf.t͡sa
dawczyni	dafˈt͡ʂɨ.ɲi
dawka	ˈdaf.ka
dawniej	ˈdav.ɲɛj
dawniejszy	davˈɲɛj.ʂɨ
dawno	ˈdawnɔ
dawny	ˈdawnɨ
dać	dat͡ɕ
daćdrapaka	dat͡ɕ draˈpa.ka
daćdupy	dat͡ɕ ˈdu.pɨ
daćnogę	dat͡ɕ ˈnɔ.ɡɛ
daćsobierękęuciąć	dat͡ɕ ˈsɔ.bʲɛ ˈrɛŋ.kɛ ˈu.t͡ɕɔɲt͡ɕ
daćspokój	dat͡ɕ ˈspɔ.kuj
dał	ˈdaw
dała	ˈdawa
dałam	ˈda.wam
dałaś	ˈda.waɕ
dałem	ˈda.wɛm
dałeś	ˈda.wɛɕ
dało	ˈda.wɔ
dbam	dbam
dbać	dbat͡ɕ
debata	dɛˈba.ta
debeściak	dɛˈbɛɕ.t͡ɕak
debil	ˈdɛ.bʲil
debiut	ˈdɛ.bʲut
dech	deχ
decha	ˈdʲexa
decymetr	d̪ɛˈt͡s̪ɨmɛt̪r̥
decyzja	dɛˈt͡sɨz.ja
dedykowanie	dɛ.dɨ.kɔˈva.ɲɛ
dedykować	dɛ.dɨˈkɔ.vat͡ɕ
dedykując	dɛ.dɨˈku.jɔnt͡s
dedykujący	dɛ.dɨ.kuˈjɔn.t͡sɨ
defetyzm	dɛˈfɛ.tɨzm
definicja	dɛ.fʲiˈɲit͡s.ja
deflacja	dɛfˈlat͡s.ja
defloracja	dɛf.lɔˈrat͡s.ja
deista	ˈdɛʲiʃtɒ
deizm	ˈdɛ.izm
dekada	dɛˈka.da
dekalog	dɛˈka.lɔk
dekan	ˈdɛ.kan
dekarz	ˈdɛ.kaʂ
dekiel	ˈdɛ.kʲɛl
dekielek	dɛˈkʲɛ.lɛk
deklinacja	dɛk.lʲiˈnat͡s.ja
dekomercjalizacja	dɛkɔmɛrt͡sjaliˈzat͡sja
dekoracyjny	dɛ.kɔ.raˈt͡sɨj.nɨ
dekret	ˈdɛ.krɛt
delegat	dɛˈlɛ.ɡat
delficki	dɛlˈfʲit͡s.kʲi
delfin	dɛlfin
delicja	dɛˈlʲit͡s.ja
delikatniejszy	dɛ.lʲi.katˈɲɛj.ʂɨ
delikatny	dɛ.lʲiˈkat.nɨ
delta	ˈdɛɫtə
demagog	dɛˈma.ɡɔk
demagogia	dɛ.maˈɡɔ.ɡʲa
dementi	dɛˈmɛn.ti
dementować	dɛ.mɛnˈtɔ.vat͡ɕ
dementując	dɛ.mɛnˈtu.jɔnt͡s
dementujący	dɛ.mɛn.tuˈjɔn.t͡sɨ
demograf	dɛˈmɔ.ɡraf
demografia	dɛ.mɔˈɡra.fʲa
demokracja	dɛ.mɔˈkrat͡s.ja
demokrata	ˈdɛmokrɒtɒ
demokratycznie	dɛ.mɔ.kraˈtɨt͡ʂ.ɲɛ
demokratyczny	dɛ.mɔ.kraˈtɨt͡ʂ.nɨ
demon	ˈdiː.mən
demoniczny	dɛ.mɔˈɲit͡ʂ.nɨ
demonologia	dɛ.mɔ.nɔˈlɔ.ɡʲa
demonstrant	ˌdeː.mɔnˈstrɑnt
demontowanie	dɛ.mɔn.tɔˈva.ɲɛ
demontować	dɛ.mɔnˈtɔ.vat͡ɕ
demontując	dɛ.mɔnˈtu.jɔnt͡s
demontujący	dɛ.mɔn.tuˈjɔn.t͡sɨ
den	dɛn
denaturat	dɛ.naˈtu.rat
dendrologia	dɛn.drɔˈlɔ.ɡʲa
denerwowanie	dɛ.nɛr.vɔˈva.ɲɛ
denerwować	dɛ.nɛrˈvɔ.vat͡ɕ
denerwując	dɛ.nɛrˈvu.jɔnt͡s
denerwujący	dɛ.nɛr.vuˈjɔn.t͡sɨ
dentysta	dɛnˈtɨ.sta
dentystka	dɛnˈtɨ.stka
dąb	dɔmp
dąsać	ˈdɔ̃.sat͡ɕ
dąć	dɔɲt͡ɕ
dął	dɔ̃w
dąłby	ˈdɔ̃w.bɨ
dąłbym	ˈdɔ̃w.bɨm
dąłbyś	ˈdɔ̃w.bɨɕ
dąłem	ˈdɔ̃.wɛm
dąłeś	ˈdɔ̃.wɛɕ
ebonit	ɛbonɪt
ebonitowy	ɛ.bɔ.ɲiˈtɔ.vɨ
echo	ˈɛkəʊ
edredon	ɛˈdrɛ.dɔn
edukacja	ɛ.duˈkat͡s.ja
edycja	ɛˈdɨt͡sja
edykt	ˈɛdɨkt
edyl	ˈɛ.dɨl
edytować	ɛ.dɨˈtɔ.vat͡ɕ
efekt	ˈɛ.fɛkt
egida	ˈɛ.d͡ʒi.da
egipski	ɛˈɡʲip.skʲi
egipskieciemności	ɛˈɡʲip.skʲɛ t͡ɕɛmˈnɔɕ.t͡ɕi
egiptolog	ɛ.ɡʲipˈtɔ.lɔk
egocentryzm	ɛ.ɡɔˈt͡sɛn.trɨzm
egoista	ə.ɡuˈis.tə
egoistycznie	ɛ.ɡɔ.iˈstɨt͡ʂ.ɲɛ
egoistyczny	ɛ.ɡɔ.iˈstɨt͡ʂ.nɨ
egoizm	ɛˈɡɔ.izm
egranizacja	ɛ.ɡra.ɲiˈzat͡s.ja
egzamin	ɛɡˈza.mʲin
egzaminować	ɛɡ.za.mʲiˈnɔ.vat͡ɕ
egzaminując	ɛɡ.za.mʲiˈnu.jɔnt͡s
egzaminujący	ɛɡ.za.mʲi.nuˈjɔn.t͡sɨ
egzonim	ɛɡˈzɔ.ɲim
egzorcysta	ɛɡ.zɔrˈt͡sɨ.sta
egzotyczniejszy	ɛɡ.zɔ.tɨt͡ʂˈɲɛj.ʂɨ
egzotyczny	ɛɡzɔˈtɨt͡ʂnɨ
egzystencja	ɛɡ.zɨˈstɛn.t͡sja
egzystencjalizm	ɛɡ.zɨ.stɛnˈt͡sja.lʲizm
einstein	ˈaj.nʂtajn
ej	aj
ejakulacja	ɛ.ja.kuˈlat͡s.ja
ekipa	ɛˈkʲi.pa
ekliptyka	ɛk.lʲipˈtɨ.ka
ekologia	ɛ.kɔˈlɔ.ɡʲa
ekologicznie	ɛ.kɔ.lɔˈɡʲit͡ʂ.ɲɛ
ekologiczniejszy	ɛ.kɔ.lɔ.ɡʲit͡ʂˈɲɛj.ʂɨ
ekologiczny	ɛ.kɔ.lɔˈɡʲit͡ʂ.nɨ
ekonomia	ɛ.kɔˈnɔ.mʲa
ekonomicznie	ɛ.kɔ.nɔˈmʲit͡ʂ.ɲɛ
ekonomiczny	ɛ.kɔ.nɔˈmʲit͡ʂ.nɨ
ekonomista	ɛ.kɔ.nɔˈmʲi.sta
ekosystem	ɛ.kɔˈsɨ.stɛm
ekran	ˈɛ.kran
ekranizacja	ɛ.kra.ɲiˈzat͡s.ja
eks	ɛks
ekshibicjonista	ɛk.sxʲi.bʲit͡s.jɔˈɲi.sta
ekshibicjonizm	ɛk.sxʲi.bʲit͡sˈjɔ.ɲizm
ekskluzywny	ɛk.skluˈzɨv.nɨ
ekskomunika	ɛk.skɔ.muˈɲi.ka
ekskomunikowanie	ɛk.skɔ.mu.ɲi.kɔˈva.ɲɛ
ekskomunikowany	ɛk.skɔ.mu.ɲi.kɔˈva.nɨ
ekskomunikować	ɛk.skɔ.mu.ɲiˈkɔ.vat͡ɕ
ekskomunikując	ɛk.skɔ.mu.ɲiˈku.jɔnt͡s
ekskomunikujący	ɛk.skɔ.mu.ɲi.kuˈjɔn.t͡sɨ
ekspedient	ɛkˈspɛd.jɛnt
ekspedientka	ɛk.spɛdˈjɛn.tka
ekspert	ˈɛk.spɛrt
ekspertka	ɛkˈspɛr.tka
eksperyment	ɛk.spɛˈrɨ.mɛnt
eksperymentalny	ɛk.spɛ.rɨ.mɛnˈtal.nɨ
eksperymentować	ɛks.pɛ.rɨ.mɛnˈtɔ.vat͡ɕ
eksplozja	ɛkˈsplɔz.ja
eksport	ˈɛk.spɔrt
eksportowanie	ɛk.spɔr.tɔˈva.ɲɛ
eksportować	ɛk.spɔrˈtɔ.vat͡ɕ
eksportując	ɛk.spɔrˈtu.jɔnt͡s
eksportujący	ɛk.spɔr.tuˈjɔn.t͡sɨ
ekspres	ˈɛk.sprɛs
ekspresjonizm	ɛk.sprɛsˈjɔ.ɲizm
ekstaza	ɛkˈsta.za
ekstremalny	ɛk.strɛˈmal.nɨ
ekstremizm	ɛkˈstrɛ.mʲizm
ekstremum	ɛkˈstrɛ.mum
ekwilibrysta	ɛk.fʲi.lʲiˈbrɨ.sta
ekwilibrystyka	ɛk.fʲi.lʲi.brɨˈstɨ.ka
elastyczny	ɛ.laˈstɨt͡ʂ.nɨ
elegancki	ɛ.lɛˈɡan.t͡skʲi
elektroda	ɛ.lɛkˈtrɔ.da
elektrolit	ɛ.lɛkˈtrɔ.lʲit
elektron	ɛlɛktrɔn
elektroniczna	ɛ.lɛk.trɔˈɲit͡ʂ.na
elektroniczny	ɛ.lɛk.trɔˈɲit͡ʂ.nɨ
elektronika	ˈɛlɛktronikɒ
elektronowolt	ɛ.lɛk.trɔ.nɔˈvɔlt
elektronowy	ɛlɛktrɔˈnɔvɨ
elektrownia	ɛ.lɛkˈtrɔv.ɲa
elektryczność	ɛ.lɛkˈtrɨt͡ʂ.nɔɕt͡ɕ
elektryczny	ɛ.lɛkˈtrɨt͡ʂ.nɨ
elektryk	ɛˈlɛk.trɨk
element	ˈel.ɪ.mənt
elementarny	ɛ.lɛ.mɛnˈtar.nɨ
elf	ɛlf
elipsa	ɛˈlʲip.sa
elita	ɛˈlʲi.ta
email	ˈiːmeɪl
embargo	ɪmˈbɑɹɡoʊ
emerytura	ɛ.mɛ.rɨˈtu.ra
emitować	ɛ.mʲiˈtɔ.vat͡ɕ
emocja	ɛˈmɔt͡s.ja
emocjonalny	ɛ.mɔt͡s.jɔˈnal.nɨ
empiryczny	ɛm.pʲiˈrɨt͡ʂ.nɨ
encyklopedia	ɛn.t͡sɨk.lɔˈpɛd.ja
endonim	ɛnˈdɔ.ɲim
enerdowski	ɛ.nɛrˈdɔf.skʲi
energetyk	ɛ.nɛrˈɡɛ.tɨk
energia	ə.nəɾˈʒi.ə
enklawa	ɛŋˈkla.va
entalpia	ˈɛntɒlpiʲɒ
enter	ˈɛntə(ɹ)
entomolog	ɛn.tɔˈmɔ.lɔk
entomologia	ɛn.tɔ.mɔˈlɔ.ɡʲa
entropia	ɛnˈtrɔ.pʲa
entuzjasta	ɛn.tuzˈja.sta
entuzjastka	ɛn.tuzˈja.stka
entuzjazm	ɛnˈtuz.jazm
enzym	ˈɛn.zɨm
epicykl	ɛ.pʲi.t͡sɨkl
epidemia	ɛ.pʲiˈdɛ.mʲa
epifit	ɛˈpʲi.fʲit
epilepsja	ɛ.pʲiˈlɛp.sja
epilog	ɛˈpʲi.lɔk
episkopat	ɛ.pʲiˈskɔ.pat
epitet	ɛˈpʲi.tɛt
epizod	ɛˈpʲi.zɔt
epoka	ɛˈpɔ.ka
epos	ˈɛ.pos
er	ɜː
era	ˈɪə̯ɹ.ə
erb	ɛrp
eremita	e.reːˈmiː.ta
ergo	ˈer.ɡoː
ergonomia	ɛr.ɡɔˈnɔ.mʲa
ergonomicznie	ɛr.ɡɔ.nɔˈmʲit͡ʂ.ɲɛ
ergonomiczny	ɛr.ɡɔ.nɔˈmʲit͡ʂ.nɨ
ergonomie	ɛʁ.ɡɔ.nɔ.mi
ero	ˈero
erom	ˈɛ.rɔm
erotyczna	ɛ.rɔˈtɨt͡ʂ.na
erotyczne	ɛ.rɔˈtɨt͡ʂ.nɛ
erotyczny	ɛ.rɔˈtɨt͡ʂ.nɨ
errata	ɛˈɹɑːtə
erudycja	ɛ.ruˈdɨt͡s.ja
erytrocyt	ɛ.rɨˈtrɔ.t͡sɨt
esemes	ɛˈsɛ.mɛs
esemesować	ˌɛ.sɛ.mɛ.ˈsɔ.vɑtɕ
esemesując	ɛ.sɛ.mɛˈsu.jɔnt͡s
esemesujący	ɛ.sɛ.mɛ.suˈjɔn.t͡sɨ
esesman	ɛˈsɛs.man
esperanto	e.speˈran.to
esteta	ɛˈstɛ.ta
estetycznie	ɛ.stɛˈtɨt͡ʂ.ɲɛ
estetyczny	ɛ.stɛˈtɨt͡ʂ.nɨ
estetyka	ɛ.stɛˈtɨ.ka
estetyzm	ɛˈstɛ.tɨzm
estoński	ɛˈstɔɲ.skʲi
etan	ˈetɑn
etanol	ˈɛtɒnol
etap	ˈɛ.tap
eter	ˈedʲer
etiopski	ɛtˈjɔp.skʲi
etruski	ˈetruski
etyka	ˈɛ.tɨ.ka
etymologia	e.ty.moˈlo.ɡi.a
eucharystia	ɛw.xaˈrɨ.stja
eucharystyczny	ɛw.xa.rɨˈstɨt͡ʂ.nɨ
eufemistycznie	ɛ.wfɛ.mʲiˈstɨt͡ʂ.ɲɛ
eufemizm	ɛˈwfɛ.mʲizm
euforia	ˈeuforiɑ
eukaliptus	ɛw.kaˈlʲip.tus
eunuchoidyzm	ɛw.nu.xɔˈi.dɨzm
euro	ˈjʊəɹəʊ
eurodance	ˌɛwrɔˈdɛ̃s
europ	ˈɛ.wrɔp
eł	ɛw
eś	ɛɕ
fabryka	ˈfa.brɨ.ka
fabuła	faˈbu.wa
faceci	faˈt͡sɛ.t͡ɕi
facet	ˈfæsɪt
faceta	faˈt͡s̪ɛt̪a
facetów	faˈt͡sɛ.tuf
fag	fæɡ
fagot	ˈfæɡ.ət
fajek	ˈfa.jɛk
fajerwerk	faˈjɛr.vɛrk
fajka	ˈfaj.ka
fajna	ˈfaj.na
fajne	ˈfaj.nɛ
fajnie	ˈfajɲɛ
fajniej	ˈfaj.ɲɛj
fajniejszy	fajˈɲɛj.ʂɨ
fajno	ˈfajn̪ɔ
fajny	ˈfaj.nɨ
faks	faks
fakt	fakt
faktdokonany	fakt dɔ.kɔˈna.nɨ
faktura	fakˈtu.ra
fal	ˈfɒl
fala	ˈfala̝
falanga	faˈlan.ɡa
falochron	faˈlɔ.xrɔn
fan	ˈfæn
fanatyczka	fa.naˈtɨt͡ʂ.ka
fanatyk	faˈna.tɨk
fanka	ˈfan.ka
fant	fant
fantastyczny	fan.taˈstɨt͡ʂ.nɨ
fantastyka	fan.taˈstɨ.ka
faraon	fara.on
farba	ˈfɒrbɒ
farby	ˈfarbɨ
farerski	faˈrɛr.skʲi
farfocel	faˈrfɔ.t͡sɛl
farma	ˈfar.ma
farmaceuta	far.maˈt͡sɛw.ta
farmaceutka	far.maˈt͡sɛw.tka
farmaceutyczny	far.ma.t͡sɛwˈtɨt͡ʂ.nɨ
farmakologia	far.ma.kɔˈlɔ.ɡʲa
farmakologiczny	far.ma.kɔ.lɔˈɡʲit͡ʂ.nɨ
farmazon	farˈma.zɔn
farsa	ˈfaɾ.sə
fart	fɑːt
fartuch	ˈfar.tux
faryzeusz	fa.rɨˈzɛ.uʂ
fasada	faˈsada
fasola	faˈsɔ.la
faszysta	faˈʂɨ.sta
faszyzm	ˈfa.ʂɨzm
fatalista	fa.taˈlʲi.sta
fater	ˈfa.tɛr
faul	faʊ̯l̩
fauna	ˈfɔː.nə
fax	fæks
faza	ˈfa.za
fałsz	fawʂ
fałszerstwo	fawˈʂɛr.stfɔ
fałszerz	ˈfaw.ʂɛʂ
fałszować	fawˈʂɔ.vat͡ɕ
fałszywka	fawˈʂɨf.ka
fałszywy	fawˈʂɨ.vɨ
fechtunek	fɛxˈtu.nɛk
felga	ˈfɛlka
felieton	fɛˈlʲɛ.tɔn
feminazistka	fɛ.mʲi.naˈʑi.stka
feministka	fɛ.mʲiˈɲi.stka
feministyczny	fɛ.mʲi.ɲiˈstɨt͡ʂ.nɨ
feminizm	fɛˈmʲi.ɲizm
fenek	ˈfɛnɛk
fenicki	fɛˈɲit͡s.kʲi
feniks	fɛˈniks
fenol	ˈfɛnɔl
fenomenologia	fɛ.nɔ.mɛ.nɔˈlɔ.ɡʲa
fenyloalanina	fɛ.nɨ.lɔ.a.laˈɲi.na
ferie	feriə
ferm	fɛrm
fermion	ˈfɜːmɪɒn
festiwal	fɛˈsti.val
feta	ˈfɛtə
ficzer	ˈfʲi.t͡ʂɛr
fideista	fiˈde̯is.ta
fideizm	fʲiˈdɛ.izm
figa	ˈfi.ɡə
figi	ˈfʲi.ɡʲi
figiel	ˈfʲi.ɡʲɛl
figowiec	fʲiˈɡɔ.vʲɛt͡s
figura	ˈfiɡurɒ
filar	ˈfʲi.lar
filc	fʲilt͡s
filiżaneczka	fʲi.lʲi.ʐaˈnɛt͡ʂ.ka
filiżanka	fʲi.lʲiˈʐan.ka
film	fɪlm
filmie	ˈfʲil.mʲɛ
filmoteka	fʲil.mɔˈtɛ.ka
filmować	fʲilˈmɔ.vat͡ɕ
filmując	fʲilˈmu.jɔnt͡s
filmujący	fʲil.muˈjɔn.t͡sɨ
filolog	fʲiˈlɔ.lɔk
filologia	fʲi.lɔˈlɔ.ɡʲa
filozof	fʲiˈlɔ.zɔf
filozofia	fʲi.lɔˈzɔ.fʲa
filozoficzny	fʲi.lɔ.zɔˈfʲit͡ʂ.nɨ
filtr	fʲiltr
finalista	fʲi.naˈlʲi.sta
finalistka	fʲi.naˈlʲi.stka
finał	ˈfʲi.naw
fiolet	fʲɔˈlɛt
fioletowawy	fʲɔ.lɛ.tɔˈva.vɨ
fioletowy	fʲɔ.lɛˈtɔ.vɨ
fiolka	ˈfʲɔl.ka
fiord	fʲɔrt
fiołek	ˈfʲɔ.wɛk
firma	ˈfɪrma
firmakrzak	ˈfʲir.ma kʂak
firmie	ˈfʲir.mʲɛ
firmy	ˈfʲir.mɨ
firmą	ˈfʲir.mɔ̃
firmę	ˈfʲir.mɛ
fistaszek	fʲiˈsta.ʂɛk
fitness	ˈfɪtnəs
fitochemia	fʲi.tɔˈxɛ.mʲa
fiut	fʲut
fizjoterapeuta	fʲiz.jɔ.tɛ.raˈpɛw.ta
fizyczny	fʲiˈzɨt͡ʂ.nɨ
fizyk	ˈfʲi.zɨk
fizyka	ˈfʲi.zɨ.ka
fiński	ˈfʲiɲ.skʲi
flacha	ˈfla.xa
flaga	ˈflaːɣa
flak	flæk
flaki	ˈfla.kʲi
flakon	flakɔnɡ
flamandzki	flaˈmant͡skʲi
flaming	ˈfleɪmɪŋ
flaszeczka	flaˈʂɛt͡ʂ.ka
flaszka	ˈflaʂ.ka
flauta	ˈflaʊtə
flecista	flɛˈt͡ɕi.sta
flegmatyczny	flɛɡ.maˈtɨt͡ʂ.nɨ
flet	flɛ
flinta	ˈflʲin.ta
flirt	flɜː(ɹ)t
flora	ˈflɔː.ɹə
florencki	flɔˈrɛn.t͡skʲi
flot	flo
flota	ˈflotɑ
fluor	fluːər
flądra	ˈflɔn.dra
fobia	ˈfobiɑ
fok	ˈfok
foka	ˈfokɒ
fokstrot	ˈfɔk.strɔt
folder	ˈfoʊɫdɚ
folia	fo.ˈli.a
folijka	fɔˈlʲij.ka
folklor	ˈfɔl.klɔr
gabinet	ɡaˈbʲi.nɛt
gacie	ˈɡa.t͡ɕɛ
gad	ɡæd
gada	ˈɡad̪ˠə
gadaj	ˈɡa.daj
gadatliwy	ɡa.datˈlʲi.vɨ
gadać	ˈɡa.dat͡ɕ
gadolin	ɡaˈdɔ.lʲin
gadzinówka	ɡa.d͡ʑiˈnuf.ka
gagauski	ɡaˈɡaw.skʲi
gaik	ˈɡa.ik
gaj	ɡaj
gaje	ˈɡaje
gajowy	ɡaˈjɔ.vɨ
gal	ɡæl
gala	ˈɡɑːlə
galaktyka	ɡaˈlak.tɨ.ka
galeon	ɡaˈlɛ.ɔn
galernik	ɡaˈlɛr.ɲik
galop	ɡalɔp
galopując	ɡa.lɔˈpu.jɔnt͡s
galopujący	ɡa.lɔ.puˈjɔn.t͡sɨ
gamajda	ɡaˈmaj.da
gamepad	ˈɡeɪm.pæd
gamoń	ˈɡa.mɔɲ
gamratka	ɡaˈmrat.ka
ganek	ˈɡa.nɛk
gangrena	ɡanˈɡrɛ.na
gap	ɡæp
gapa	ˈkaːpa
gapićsię	ˈɡa.pʲit͡ɕ.ɕɛ
garaż	ˈɡa.raʂ
garb	ɡɑː(ɹ)b
garbarz	ˈɡar.baʂ
garbując	ɡarˈbu.jɔnt͡s
garbujący	ɡar.buˈjɔn.t͡sɨ
garbus	ˈɡar.bus
garderoba	ɡar.dɛˈrɔ.ba
gardzi	ˈɡar.d͡ʑi
gardzicie	ɡarˈd͡ʑi.t͡ɕɛ
gardziel	ˈɡar.d͡ʑɛl
gardzimy	ɡarˈd͡ʑi.mɨ
gardzisz	ˈɡar.d͡ʑiʂ
gardzić	ˈɡar.d͡ʑit͡ɕ
gardził	ˈɡar.d͡ʑiw
gardziła	ɡarˈd͡ʑi.wa
gardziłaby	ɡar.d͡ʑiˈwa.bɨ
gardziłabym	ɡar.d͡ʑiˈwa.bɨm
gardziłabyś	ɡar.d͡ʑiˈwa.bɨɕ
gardziłam	ɡarˈd͡ʑi.wam
gardziłaś	ɡarˈd͡ʑi.waɕ
gardziłby	ɡarˈd͡ʑiw.bɨ
gardziłbym	ɡarˈd͡ʑiw.bɨm
gardziłbyś	ɡarˈd͡ʑiw.bɨɕ
gardziłem	ɡarˈd͡ʑi.wɛm
gardziłeś	ɡarˈd͡ʑi.wɛɕ
gardziło	ɡarˈd͡ʑi.wɔ
gardziłoby	ɡar.d͡ʑiˈwɔ.bɨ
gardzą	ˈɡar.d͡zɔ̃
gardzę	ˈɡar.d͡zɛ
gardło	ˈɡar.dwɔ
garnek	ˈɡar.nɛk
garnirunek	ˌɡarʲɲiˈrũnɛk
garnitur	ɡarˈɲi.tur
garnuszek	ɡarˈnu.ʂɛk
garnąć	ˈɡar.nɔɲt͡ɕ
garści	ˈɡar.ɕt͡ɕi
garść	ɡarɕt͡ɕ
gasi	ˈɡaɕi
gasić	ˈɡa.ɕit͡ɕ
gasnąć	ˈɡas.nɔɲt͡ɕ
gastrofaza	ɡa.strɔˈfa.za
gaszę	ˈɡa.ʂɛ
gatunek	ɡaˈtu.nɛk
gaworzyć	ɡaˈvɔ.ʐɨt͡ɕ
gawron	ˈɡa.vrɔn
gaz	ɡɑz
gazdodechy	ˈɡas dɔ ˈdɛxɨ
gazela	ɡaˈzɛ.la
gazeta	ɡaˈzɛ.ta
gazetowy	ɡazɛˈtɔvɨ
gazowy	ɡaˈzɔ.vɨ
gazziemny	ɡas ˈʑɛm.nɨ
gazłupkowy	ɡas vupˈkɔ.vɨ
gała	ˈɡa.wa
gałeczka	ɡaˈwɛt͡ʂ.ka
gałka	ˈɡaw.ka
gałkamuszkatołowa	ˈɡaw.ka muʂ.ka.tɔˈwɔ.va
gałązka	ɡaˈwɔ̃.ska
gałąź	ˈɡa.wɔɲɕ
gaś	ɡaɕ
gaśnica	ɡaɕˈɲi.t͡sa
gaźnik	ˈɡaʑ.ɲik
gaża	ˈɡa.ʐa
gąbka	ˈɡɔm.pka
gąsienica	ɡɔɲ.ɕɛˈɲi.t͡sa
gąsior	ˈɡɔɲ.ɕɔr
gąsiorek	ɡɔɲˈɕɔ.rɛk
gąsię	ˈɡɔɲ.ɕɛ
gąska	ˈɡɔ̃.ska
habit	ˈhæbɪt
hacham	ˈxaxam
haczyk	ˈxa.t͡ʂɨk
hadis	ˈxa.dis
hadron	ˈhæd.ɹɑn
haf	haːv
hafn	xafn
haft	hæft
haftować	xafˈtɔ.vat͡ɕ
hajs	xajs
hak	haːk
haki	ˈhaːcɪ
hal	hal
hala	ˈa.lə
halabarda	xa.laˈbar.da
hale	heɪl
halibut	ˈhæ.lɨ.bət
halo	ˈheɪləʊ
hamak	ˈxa.mak
hamowanie	xa.mɔˈva.ɲɛ
hamować	xaˈmɔ.vat͡ɕ
hamując	xaˈmu.jɔnt͡s
hamujący	xa.muˈjɔn.t͡sɨ
hamulec	xaˈmu.lɛt͡s
handel	ˈɦɑn.dəl
handlarka	xanˈdlar.ka
handlarz	ˈxan.dlaʂ
hangar	ˈhæŋə
haracz	ˈxa.rat͡ʂ
harakiri	xaraˈkiri
harcerz	ˈxar.t͡sɛʂ
harda	ˈhaːɾˠd̪ˠə
harde	aʁd
hardość	ˈxar.dɔɕt͡ɕ
hardy	ˈhɑɹdi
harem	ˈhɑːɹiːm
harfa	ɦarfa
harmonia	əɾ.muˈni.ə
harmonogram	xar.mɔˈnɔ.ɡram
harować	xaˈrɔ.vat͡ɕ
harpun	ˈxar.pun
hart	hɑːt
hartducha	xart ˈdu.xa
hartować	xarˈtɔ.vat͡ɕ
has	hæz
hasać	ˈxa.sat͡ɕ
haszcze	ˈxaʂ.t͡ʂɛ
haszysz	ˈxa.ʂɨʂ
hasło	ˈxa.swɔ
haubica	xawˈbʲi.t͡sa
hawajski	xaˈvaj.skʲi
hazard	ˈhæzɚd
hałas	ˈxawas̪
hańba	ˈxaɲ.ba
headshot	ˈxɛt.ʂɔt
heban	ˈxɛ.ban
hebel	ˈxɛ.bɛl
hebrajska	xɛˈbraj.ska
hebrajski	xɛˈbraj.skʲi
hebrajskie	xɛˈbraj.skʲɛ
hedonista	xɛ.dɔˈɲi.sta
hedonizm	xɛˈdɔ.ɲizm
hegemonia	xɛ.ɡɛˈmɔɲ.ja
heheszki	xɛˈxɛʂ.kʲi
hej	haj
hejt	xɛjt
hejter	ˈxɛj.tɛr
heksan	ˈxɛk.san
hektar	ˈxɛkt̪ar
hel	heːl
heliocentryzm	xɛ.lʲɔˈt͡sɛn.trɨzm
helisa	xɛˈlʲi.sa
hemoliza	xɛ.mɔˈlʲi.za
henr	xɛ̃n̪r̥
heptan	ˈxɛp.tan
herb	hɜːb
herbaciarnia	xɛr.baˈt͡ɕar.ɲa
herbata	xɛrˈba.ta
herbu	ɛʁ.by
herby	ˈxɛrbɨ
herc	xɛrt͡s̪
heretycki	xɛ.rɛˈtɨt͡s.kʲi
heretyk	xɛˈrɛ.tɨk
herezja	xɛˈrɛz.ja
heroina	xɛ.rɔˈi.na
herszt	xɛrʂt
heteroseksualizm	xɛ.tɛ.rɔ.sɛk.suˈa.lʲizm
hetman	ˈxɛt.man
hełm	xɛwm
hibernacja	xʲi.bɛrˈnat͡s.ja
hidżab	ˈxʲi.d͡ʐap
hiena	ˈie.na
hienacmentarna	ˈxʲɛ.na t͡smɛnˈtar.na
hierarcha	hi.eˈrar.kʰa
hierarchini	xʲɛ.rarˈxʲi.ɲi
hieroglif	xʲɛˈrɔɡ.lʲif
higiena	xʲiˈɡʲɛ.na
higienicznie	xʲi.ɡʲɛˈɲit͡ʂ.ɲɛ
himalajski	xʲi.maˈlaj.skʲi
hindi	ˈhindi
hinduizm	xʲinˈdu.izm
hiperbola	ˈhipɛrbolɒ
hipis	ˈxʲi.pʲis
hipokryzja	xʲi.pɔˈkrɨz.ja
hipopotam	xʲi.pɔˈpɔ.tam
hipoteka	xʲi.pɔˈtɛ.ka
hipoteza	xʲi.pɔˈtɛ.za
hiragana	ˌhɪ.ɹəˈɡæ.nə
histereza	xʲi.stɛˈrɛ.za
histeryczka	xʲi.stɛˈrɨt͡ʂ.ka
histeryk	xʲiˈstɛ.rɨk
historia	histoˈria
historii	xʲiˈs̪t̪ɔrʲji
historię	xʲiˈstɔ.rʲɛ
historyczny	xʲi.stɔˈrɨt͡ʂ.nɨ
historyk	xʲiˈstɔ.rɨk
histydyna	xʲi.stɨˈdɨ.na
hiszpański	xʲiʂˈpaɲ.skʲi
hit	hɪt
hobby	ˈhɒ.bi
hodować	xɔˈdɔ.vat͡ɕ
hodowca	xɔˈdɔf.t͡sa
hodowla	xɔˈdɔv.la
hojniejszy	xɔjˈɲɛj.ʂɨ
hojność	ˈxɔj.nɔɕt͡ɕ
hojny	ˈxɔj.nɨ
hokeista	xɔ.kɛˈi.sta
hokej	ʹɦokɛj
hokejowy	xɔ.kɛˈjɔ.vɨ
hokejówka	xɔ.kɛˈjuf.ka
hol	hoːl
holenderski	xɔ.lɛnˈdɛr.skʲi
holm	həʊm
holownik	xɔˈlɔv.ɲik
homar	ˈxɔmar
homeopatia	xɔ.mɛ.ɔˈpat.ja
homofobia	o̞mo̞ˈfo̞βja̠
homoniewiadomo	ˈxɔ.mɔ ɲɛ.vʲaˈdɔ.mɔ
homoseksualista	xɔ.mɔ.sɛk.su.aˈlʲi.sta
homoseksualizm	xɔ.mɔ.sɛk.suˈa.lʲizm
homoseksualność	xɔ.mɔ.sɛk.suˈal.nɔɕt͡ɕ
homoseksualny	xɔ.mɔ.sɛk.suˈal.nɨ
hongkoński	hɔŋˈkɔɲ.ski
horda	ˈhordɒ
hormon	ˈxɔr.mɔn
horoskop	ˈɦo.ro.skop
horyzont	xɔˈrɨ.zɔnt
hostia	ˈhos.ti.a
hotel	həʊˈtɛl
hotelu	xɔˈtɛ.lu
house	haʊs
hołd	xɔwt
hołota	xɔˈwɔ.ta
hoży	ˈxɔ.ʐɨ
i	aɪ
ibis	ˈaɪ.bɪs
iBook	ˈaj.buk
ich	itʃ
ichtiologia	ix.tjɔˈlɔ.ɡʲa
idealna	i.dɛˈal.na
idealne	i.dɛˈal.nɛ
idealny	i.dɛˈal.nɨ
ideał	iˈdɛ.aw
identyfikować	i.dɛn.tɨ.fʲiˈkɔ.vat͡ɕ
identyfikując	i.dɛn.tɨ.fʲiˈku.jɔnt͡s
identyfikujący	i.dɛn.tɨ.fʲi.kuˈjɔn.t͡sɨ
idiom	ˈɪdɪəm
idiomatyczny	i.di.ɔ.maˈtɨt͡ʂ.nɨ
idiota	i.diˈoː.ta
idiotoodporny	iˌdʲɔ.tɔ.ʔɔtˈpɔr.nɨ
idiotą	i.diˈɔ.tɔ̃
idol	ˈaɪd(ə)l
idola	iˈdɔla
idole	i.dɔl
idzie	ˈi.d͡ʑɛ
idziecie	iˈd͡ʑɛ.t͡ɕɛ
idziemy	iˈd͡ʑɛ.mɨ
idziesz	ˈi.d͡ʑɛʂ
idą	ˈi.dɔ̃
idąc	ˈi.dɔnt͡s
idę	ˈi.dɛ
idź	it͡ɕ
idźcie	ˈit͡ɕ.t͡ɕɛ
igiełka	iˈɡʲɛw.ka
iglasty	iɡˈla.stɨ
igloo	ˈɪɡluː
ignorowanie	iɡ.nɔ.rɔˈva.ɲɛ
ignorować	iɡ.nɔˈrɔ.vat͡ɕ
ignorując	iɡ.nɔˈru.jɔnt͡s
ignorujący	iɡ.nɔ.ruˈjɔn.t͡sɨ
igrać	ˈi.ɡrat͡ɕ
igrek	ˈi.ɡrɛk
igrzyska	iˈɡʐɨ.ska
iguana	ɪˈɡwɑːnə
igła	ˈi.ɡwa
ikona	iˈkɔ.na
ikonostas	i.kɔˈnɔ.stas
ile	ˈiː.le
ilemaszlat	ˈi.lɛ maʂ lat
iloczyn	iˈlɔ.t͡ʂɨn
iloraz	iˈlɔ.ras
ilość	ˈi.lɔɕt͡ɕ
ilustracja	i.luˈstrat͡s.ja
im	ɪm
iMac	ˈajmak
imadło	iˈma.dwɔ
imbir	ˈim.bʲir
imbirowy	im.bʲiˈrɔ.vɨ
imienia	iˈmʲɛ.ɲa
imieniem	iˈmʲɛ.ɲɛm
imieniny	i.mʲɛˈɲi.nɨ
imieniu	iˈmʲɛ.ɲu
imiesłów	iˈmʲɛ.swuf
imiona	iˈmjɔna
imitacja	i.mʲiˈta.t͡sʲja
imię	ˈi.mʲɛ
immunitet	im.muˈɲi.tɛt
implozja	imˈplɔzja
imponować	im.pɔˈnɔ.vat͡ɕ
importując	im.pɔrˈtu.jɔnt͡s
importujący	im.pɔr.tuˈjɔn.t͡sɨ
impotencja	im.pɔˈtɛn.t͡sja
impreza	imˈprɛ.za
imprezę	imˈprɛ.zɛ
impuls	ˈim.puls
inaczej	iˈna.t͡ʂɛj
ind	int
indoeuropejski	in.dɔ.ɛ.wrɔˈpɛj.skʲi
indonezyjski	in.dɔ.nɛˈzɨj.skʲi
indyczka	inˈdɨt͡ʂ.ka
indyjski	inˈdɨj.skʲi
indyk	ˈin.dɨk
infekcja	iˈnfɛk.t͡sja
inflacja	iˈnflat͡s.ja
informacja	i.nfɔrˈmat͡s.ja
informacje	i.nfɔrˈmat͡s.jɛ
informacji	i.nfɔrˈmat͡s.ji
informatyk	i.nfɔrˈma.tɨk
informatyka	in.fɔrˈma.tɨk.a
informować	i.nfɔrˈmɔ.vat͡ɕ
infraczerwony	i.nfra.t͡ʂɛrˈvɔ.nɨ
infrastruktura	i.nfra.strukˈtu.ra
ingerencja	in.ɡɛˈrɛn.t͡sja
inkaust	ˈin.kawst
inkunabuł	inkunabuw
inna	ˈɪnːa
inne	ˈɪn̠ʲə
innego	ĩˈn̪ːɛɡɔ
innej	ˈĩn̪ːɛj
innemu	ĩˈn̪ːɛ̃mu
inni	ˈinːi
inny	ˈin.nɨ
innych	ˈĩn̪ːɨx
innym	ˈĩn̪ːɨ̃m
innymi	ĩˈn̪ːɨ̃mʲi
innymisłowy	inˈnɨ.mʲi ˈswɔ.vɨ
inną	ˈĩn̪ːɔ̃w̃
insidejob	ˌinsajd ˈd͡ʐɔp
insidejoba	ˌinsajd ˈd͡ʐɔba
insidejobach	ˌinsajd ˈd͡ʐɔbax
insidejobami	ˌinsajd d͡ʐɔˈbami
insidejobem	ˌinsajd ˈd͡ʐɔbɛm
insidejobie	ˌinsajd ˈd͡ʐɔbje
insidejobom	ˌinsajd ˈd͡ʐɔbɔm
insidejobowi	ˌinsajd d͡ʐɔˈbɔvi
insidejoby	ˌinsajd ˈd͡ʐɔbɨ
insidejobów	ˌinsajd ˈd͡ʐɔbuf
instalacyjny	in.sta.laˈt͡sɨj.nɨ
instalować	in.staˈlɔ.vat͡ɕ
instytut	inˈstɨ.tut
insulina	in.suˈlʲi.na
insynuacja	in.sɨ.nuˈat͡s.ja
insynuować	in.sɨ.nuˈɔ.vat͡ɕ
inteligencja	in.tɛ.lʲiˈɡɛn.t͡sja
inteligentniejszy	in.tɛ.lʲi.ɡɛnˈtɲɛj.ʂɨ
inteligentny	in.tɛ.lʲiˈɡɛn.tnɨ
intensywny	in.tɛ̃ˈsɨv.nɨ
interes	inˈtɛ.rɛs
interesu	in.tɛˈrɛ.su
interesuje	in.tɛ.rɛˈsu.jɛ
interesy	in.tɛˈrɛ.sɨ
internetowa	in.tɛr.nɛˈtɔ.va
internetowy	in.tɛr.nɛˈtɔ.vɨ
internista	in.tɛrˈɲi.sta
interpunkcja	in.tɛrˈpun.kt͡sja
interpunkcyjny	in.tɛr.punˈkt͡sɨj.nɨ
intryga	inˈtrɨ.ɡa
intymniejszy	in.tɨmˈɲɛj.ʂɨ
intymny	inˈtɨm.nɨ
inwalida	in.vaˈlʲi.da
inwestycja	in.vɛˈstɨt͡s.ja
inżynieria	in.ʐɨˈɲɛ.rʲa
iPhone	ˈa.jfɔn
iPod	ˈaj.pɔt
irlandzki	irˈlan.t͡skʲi
ironia	iː.roːˈniː.a
ironicznie	i.rɔˈɲit͡ʂ.ɲɛ
ironie	i.ʁɔ.ni
iryd	ˈi.rɨt
iskać	ˈi.skat͡ɕ
iskra	ˈi.skra
islam	i.slam
islamofobia	is.la.mɔˈfɔ.bʲa
islamski	isˈlam.skʲi
islandzki	isˈlan.t͡skʲi
istnieje	iˈstɲɛ.jɛ
istnieją	iˈstɲɛ.jɔ̃
istnienie	iˈstɲɛ.ɲɛ
istnieć	ˈi.stɲɛt͡ɕ
istota	iˈstɔ.ta
itakdalej	i tak ˈda.lɛj
iterb	ˈi.tɛrp
itr	itr
ityle!	i ˈtɨ.lɛ
izba	ɪzˈbɑː
izdebka	izˈdɛp.ka
ił	iw
iść	iɕt͡ɕ
iśćwcholerę	ˈiɕt͡ɕ fxɔˈlɛ.rɛ
ja	jaː
jabol	ˈja.bɔl
jabłczan	ˈja.bwt͡ʂan
jabłecznik	jaˈbwɛt͡ʂ.ɲik
jabłko	ˈjapw.kɔ
jabłkoAdama	ˈjap.kɔ aˈda.ma
jabłkowy	japwˈkɔ.vɨ
jabło	ˈja.bwɔ
jabłoniowy	ja.bwɔˈɲɔ.vɨ
jabłoń	ˈja.bwɔɲ
jacy	ˈjat͡s̪ɨ
jad	jat
jadalnia	jaˈdal.ɲa
jadalny	jaˈdal.nɨ
jadać	ˈja.dat͡ɕ
jadowity	ja.dɔˈvʲi.tɨ
jadą	ˈja.dɔ̃
jadąc	ˈja.dɔnt͡s
jadło	ˈja.dwɔ
jadłowstręt	jaˈdwɔf.strɛnt
jagnię	ˈjaɡ.ɲɛ
jagnięcina	jaɡ.ɲɛɲˈt͡ɕi.na
jagnięcy	jaɡˈɲɛn.t͡sɨ
jagoda	ˈjaɡɔda
jaguar	ˈdʒæɡjuːə
jajach	ˈjajax
jajco	ˈjaj.t͡sɔ
jajecznica	ja.jɛt͡ʂˈɲi.t͡sa
jajeczny	jaˈjɛt͡ʂ.nɨ
jajka	ˈjaj.ka
jajko	ˈjajkɔ
jajnik	ˈjaj.ɲik
jajo	ˈjajɔ
jajowaty	ja.jɔˈva.tɨ
jajowód	jaˈjɔ.vut
jak	jak
jaka	ˈjaka
jakaś	ˈja.kaɕ
jakdiabli	jak ˈdjab.lʲi
jakgrochościanę	jak ˈɡrɔx ɔ ˈɕt͡ɕa.nɛ
jaki	ˈjaːcɪ
jakich	ˈjacix
jakie	ˈjacɛ
jakiego	jaˈcɛɡɔ
jakiej	ˈjacej
jakiemu	jaˈcɛ̃mu
jakikolwiek	ja.kʲiˈkɔl.vʲɛk
jakim	ˈjacĩm
jakimi	jaˈcimʲi
jakiś	ˈja.kʲiɕ
jakkolwiek	jakˈkɔl.vʲɛk
jakkrewznosa	jak ˈkrɛf ˈznɔ.sa
jakkurapazurem	jak ˈku.ra paˈzu.rɛm
jakmasznaimię	jak maʂ na ˈi.mʲɛ
jako	ˈjako
jakoby	ˈjakobɪ
jakoś	ˈja.kɔɕ
jakość	ˈja.kɔɕt͡ɕ
jaksięmasz	jak ɕɛ ˈmaʂ
jaksłońwskładzieporcelany	jak ˈswɔɲ ˈfskwa.d͡ʑɛ pɔr.t͡sɛˈla.nɨ
jaktam	jak tam
jaktylko	jak ˈtɨl.kɔ
jakzkoziejdupytrąba	jak ˈskɔ.ʑɛj ˈdu.pɨ ˈtrɔm.ba
jakzwał,takzwał	jaɡˈzvaw taɡˈzvaw
jaką	ˈjakɔ̃w̃
jakąś	ˈja.kɔɲɕ
jama	ˈja.ma
jamajski	jaˈmaj.skʲi
jamnik	ˈjam.ɲik
jamochłon	jaˈmɔ.xwɔn
janczar	ˈjan.t͡ʂar
jantar	ˈjantaɾ
janusz	ˈja.nuʂ
japa	ˈja.pa
japierdolę	ja pʲɛrˈdɔ.lɛ
japoniec	jaˈpɔ.ɲɛt͡s
japonka	jaˈpɔn.ka
japoński	jaˈpɔɲ.skʲi
jar	dʒɑɹ
jard	jart
jarda	ˈjar.da
jarmark	ˈjar.mark
jarmuż	ˈjarmuʂ
jary	ˈjarɨ
jarzmo	ˈjaʐ.mɔ
jarzynowa	ja.ʐɨˈnɔ.va
jarzyć	ˈja.ʐɨt͡ɕ
jarząb	ˈja.ʐɔmp
jarząbek	jaˈʐɔm.bɛk
jarząbowy	ja.ʐɔmˈbɔ.vɨ
jarzębatka	jaʐɛmˈbatka
jarzębina	ja.ʐɛmˈbʲi.na
jasiek	ˈja.ɕɛk
jałmużna	jawˈmuʐ.na
jałowcowy	ja.wɔfˈt͡sɔ.vɨ
jałowiec	jaˈwɔ.vʲɛt͡s
jałowy	jaˈwɔ.vɨ
jałówka	jaˈwuf.ka
kabaczek	kaˈba.t͡ʂɛk
kabanos	kaˈba.nɔs
kabardyjski	kabarˈd̪ɨjs̪ci
kabaret	kaˈba.rɛt
kabała	kaˈbawa
kabel	kabɛl
kablować	kabˈlɔ.vat͡ɕ
kablówka	kabˈluf.ka
kabriolet	kabˈrʲɔ.lɛt
kabylski	kaˈbɨl.skʲi
kac	kat͡s
kacap	ˈka.t͡sap
kacenjamer	ka.t͡sɛnˈja.mɛr
kacerz	ˈka.t͡sɛʂ
kacmoralny	kat͡s mɔˈral.nɨ
kaczan	ˈka.t͡ʂan
kaczka	ˈkat͡ʂ.ka
kaczkadziennikarska	ˈkat͡ʂ.ka d͡ʑɛɲ.ɲiˈkar.ska
kaczogrodzki	ka.t͡ʂɔˈɡrɔt͡s.kʲi
kaczor	ˈka.t͡ʂɔr
kaczuszka	kaˈt͡ʂuʂ.ka
kaczyzm	ˈka.t͡ʂɨzm
kaczątko	kaˈt͡ʂɔn.tkɔ
kaczę	ˈka.t͡ʂɛ
kadencja	kaˈdɛn.t͡sja
kadet	ˈkadɛt
kadm	kadm
kadzidło	kaˈd͡ʑi.dwɔ
kadzielnica	ka.d͡ʑɛlˈɲi.t͡sa
kadzić	ˈka.d͡ʑit͡ɕ
kadłub	ˈka.dwup
kadź	kat͡ɕ
kafar	ˈka.far
kaganiec	kaˈɡa.ɲɛt͡s
kajak	ˈkɒjɒk
kajaku	kaˈjaku
kajać	ˈka.jat͡ɕ
kajet	ˈka.jɛt
kajman	ˈkaj.man
kajzerka	kajˈzɛr.ka
kakadu	ˈkɑkɑdu
kakao	kakaːo
kakaowiec	ka.kaˈɔ.vʲɛt͡s
kakaowy	ka.kaˈɔ.vɨ
kaktus	kaktus
kaktusowy	kak.tuˈsɔ.vɨ
kalafior	kaˈla.fʲɔr
kalafonia	ka.laˈfɔ.ɲa
kalarepa	ka.laˈrɛ.pa
kalać	ˈka.lat͡ɕ
kalcyt	ˈkal.t͡sɨt
kaledoński	ka.lɛˈdɔɲ.skʲi
kalejdoskop	ka.lɛjˈdɔ.skɔp
kaleka	kaˈlɛ.ka
kalendarz	kaˈlɛn.daʂ
kalesony	ka.lɛˈsɔ.nɨ
kaleta	kaˈlɛ.ta
kaliforn	kaˈlʲi.fɔrn
kalina	kaˈlʲi.na
kalk	ˈkalk
kalka	ˈkʰal̥ka
kalkulator	kal.kuˈla.tɔr
kalosz	ˈka.lɔʂ
kalumnia	kaˈlum.ɲa
kalwinista	kal.vʲiˈɲi.sta
kalwinizm	kalˈvʲi.ɲizm
kambodżański	kam.bɔˈd͡ʐaɲ.skʲi
kameleon	kɑmələuːn
kamera	ˈkamɛra
kameruński	ka.mɛˈruɲ.skʲi
kamerzysta	ka.mɛˈʐɨ.sta
kamerę	kaˈmɛ.rɛ
kamica	kaˈmʲi.t͡sa
kamieniarz	kaˈmʲɛɲaʂ
kamienica	ka.mʲɛˈɲi.t͡sa
kamienicy	ka.mʲɛˈɲi.t͡sɨ
kamieniołom	ka.mʲɛˈɲɔ.wɔm
kamienisty	ka.mʲɛˈɲi.stɨ
kamienny	kaˈmʲɛn.nɨ
kamień	ˈka.mʲɛɲ
kamionka	kaˈmʲɔn.ka
kamizelka	ka.mʲiˈzɛl.ka
kamyk	ˈka.mɨk
kanadyjski	ka.naˈdɨj.skʲi
kanalizacja	ka.na.lʲiˈzat͡s.ja
kanapa	kaˈna.pa
kanapeczka	ka.naˈpɛt͡ʂ.ka
kanapka	kaˈnap.ka
kanar	ˈka.nar
kanarek	kaˈna.rɛk
kanasta	kaˈnasta
kanał	ˈka.naw
kandela	ˈkɑndelɑ
kandelabr	kanˈdɛ.labr
kandydat	kanˈdɨ.dat
kangur	ˈkan.ɡur
kania	ˈka.ɲa
kanibal	kaˈɲi.bal
kanikuła	ka.ɲiˈku.wa
kanion	ˈkaɲ.jɔn
kanonierka	ka.nɔˈɲɛr.ka
kanonizacja	ka.nɔ.ɲiˈzat͡s.ja
kant	kɑnt
kantar	kənˈtɑ
kantata	ˈkʰan̥taːta
kanton	ˈkɒnton
kantor	kan.tor
kaodaizm	ka.ɔˈda.izm
kaon	ka.ɔ̃
kapa	ˈkɒpɒ
kapać	ˈka.pat͡ɕ
kapela	kaˈpɛ.la
kapelmistrz	kaˈpɛl.mʲistʂ
kapelusz	kaˈpɛ.luʂ
kapeć	ˈka.pɛt͡ɕ
kapitalista	ka.pʲi.taˈlʲi.sta
kapitalistyczny	ka.pʲi.ta.lʲiˈstɨt͡ʂ.nɨ
kapitalizm	ka.pʲiˈta.lʲizm
kapitan	kaˈpʲi.tan
kapitana	ka.pʲiˈta.na
kapitanem	ka.pʲiˈta.nɛm
kapitanie	kapʲiˈt̪ãɲɛ
kapitanowi	ka.pʲi.taˈnɔ.vʲi
kapitel	kaˈpʲi.tɛl
kapitulacja	ka.pʲi.tuˈlat͡s.ja
kaplica	kapˈlʲi.t͡sa
kapo	ˈkapo
kapować	kaˈpɔ.vat͡ɕ
kaprawy	kaˈpra.vɨ
kapryśny	kaˈprɨɕ.nɨ
kapłan	ˈka.pwan
kapłaństwo	kaˈpwaɲ.stfɔ
kał	kaw
kałamarnica	ka.wa.marˈɲi.t͡sa
kałamarz	kaˈwa.maʂ
kałuża	kaˈwu.ʐa
label	ˈleɪbəl
labirynt	laˈbʲi.rɨnt
laboratorium	la.boː.raːˈtoː.ri.um
lada	ˈla.da
laguna	laˈɡu.na
lakier	ˈlakʲɛr
lakmus	ˈlɑkmus
lakoniczna	la.kɔˈɲit͡ʂ.na
lakoniczne	la.kɔˈɲit͡ʂ.nɛ
lakoniczny	lakɔˈɲit͡ʂnɨ
laktaza	lakˈta.za
laktoza	lakˈtɔ.za
laleczka	laˈlɛt͡ʂ.ka
lalka	ˈlal.ka
lama	ˈlɑː.mə
lambda	ˈlæm.də
lampa	ˈlampa
lampart	ˈlam.part
landszaft	ˈlan.tʂaft
langusta	ˈlaŋgusta
lankijski	lanˈkʲij.skʲi
lans	lans
lansować	lanˈsɔ.vat͡ɕ
lantan	ˈlan.tan
lantanowiec	lan.taˈnɔ.vʲɛt͡s
laotański	la.ɔˈtaɲ.skʲi
lapoński	laˈpɔɲ.skʲi
laptop	ˈlæp.tɒp
larum	ˈla.rum
larwa	ˈlar.va
laryngolog	la.rɨnˈɡɔ.lɔk
las	lɑ
lasek	ˈla.sɛk
laser	ˈleɪz.ə(ɹ)
laska	ˈla.ska
laskach	ˈlaskax
laski	ˈlas.kʲi
lasu	ˈlasu
lat	lɑːt
lata	ˈlata̝
latach	ˈla.tax
latając	laˈta.jɔnt͡s
latający	la.taˈjɔn.t͡sɨ
latarka	laˈtar.ka
latarnia	laˈtar.ɲa
latarniowiec	la.tarˈɲɔ.vʲɛt͡s
latawiec	laˈta.vʲɛt͡s
latać	ˈla.tat͡ɕ
lato	ˈlɑt̪o
lawa	ˈlawa
lawenda	laˈvɛn.da
lawina	laˈvʲi.na
lać	lat͡ɕ
laćjakzcebra	ˈlat͡ɕ jak ˈst͡sɛ.bra
laćwodę	lat͡ɕ ˈvɔ.dɛ
leasing	ˈliːsɪŋ
lec	ˈleːk
leci	ˈlɛ.t͡ɕi
leciał	ˈlɛ.t͡ɕaw
leciała	lɛˈt͡ɕa.wa
leciałaby	lɛ.t͡ɕaˈwa.bɨ
leciałabym	lɛ.t͡ɕaˈwa.bɨm
leciałabyś	lɛ.t͡ɕaˈwa.bɨɕ
leciałam	lɛˈt͡ɕa.wam
leciałaś	lɛˈt͡ɕa.waɕ
leciałby	lɛˈt͡ɕaw.bɨ
leciałbym	lɛˈt͡ɕaw.bɨm
leciałbyś	lɛˈt͡ɕaw.bɨɕ
leciałem	lɛˈt͡ɕa.wɛm
leciałeś	lɛˈt͡ɕa.wɛɕ
leciało	lɛˈt͡ɕa.wɔ
leciałoby	lɛ.t͡ɕaˈwɔ.bɨ
lecicie	lɛˈt͡ɕi.t͡ɕɛ
lecieć	ˈlɛ.t͡ɕɛt͡ɕ
lecimy	lɛˈt͡ɕi.mɨ
lecisz	ˈlɛ.t͡ɕiʂ
lecz	lɛt͡ʂ
leczenie	lɛˈt͡ʂɛ.ɲɛ
leczyć	ˈlɛ.t͡ʂɨt͡ɕ
lecą	ˈlɛ.t͡sɔ̃
lecę	ˈlɛ.t͡sɛ
ledwie	ˈlɛd.vʲɛ
ledwo	ˈlɛd.vɔ
legalny	lɛˈɡal.nɨ
legenda	ˈlɛɡɛndɒ
legion	ˈliːdʒən
legionista	lɛ.ɡʲɔˈɲi.sta
legitymizować	lɛ.ɡʲi.tɨ.mʲiˈzɔ.vat͡ɕ
legowisko	lɛ.ɡɔˈvʲi.skɔ
lej	lɑj
lekarka	lɛˈkar.ka
lekarstwo	lɛˈkar.stfɔ
lekarz	ˈlɛ.kaʂ
lekarza	lɛˈka.ʐa
lekarze	lɛˈka.ʐɛ
lekcja	ˈlɛk.t͡sja
lekcje	ˈlɛk.t͡sjɛ
lekki	ˈlɛk.kʲi
lekko	ˈlɛk.kɔ
lekkoatleta	lɛk.kɔ.atˈlɛ.ta
lekkoatletyka	lɛk.kɔ.atˈlɛ.tɨ.ka
leksem	ˈlɛk.sɛm
leku	ˈlɛku
lelek	ˈlɛlɛk
lemiesz	ˈlɛ.mʲɛʂ
leming	ˈlɛ.mʲink
lemoniada	lɛ.mɔˈɲa.da
len	lɛn
leninowski	lɛ.ɲiˈnɔf.skʲi
lenistwo	lɛˈɲi.stfɔ
leniwiec	lɛˈɲi.vʲɛt͡s
leniwy	lɛˈɲi.vɨ
lep	ˈlɛp
lepiej	ˈlɛ.pʲɛj
lepić	ˈlɛ.pʲit͡ɕ
lepki	ˈlɛp.kʲi
lepsiejszy	lɛpˈɕɛj.ʂɨ
lepsza	ˈlɛp.ʂa
lepszy	ˈlɛp.ʂɨ
lepton	ˈlɛptɒn
lesba	ˈlɛz.ba
lesbijka	lɛzˈbʲij.ka
leseferyzm	lɛ.sɛˈfɛ.rɨzm
lesie	ˈlɛ.ɕɛ
less	lɛs
leszcz	lɛʂt͡ʂ
leszczyna	lɛʂˈt͡ʂɨ.na
letni	ˈlɛt.ɲi
leucyna	lɛwˈt͡sɨ.na
lew	lɛˑʊ
lewa	ˈlɛ.va
lewacki	lɛˈvat͡s.kʲi
lewactwo	lɛˈvat͡s.tfɔ
lewak	ˈlɛ.vak
lewe	ˈlɛ.vɛ
lewica	lɛˈvʲi.t͡sa
lewicowy	lɛ.vʲiˈt͡sɔ.vɨ
leworęczny	lɛ.vɔˈrɛn.t͡ʂnɨ
lewy	ˈlɛ.vɨ
leć	lɛt͡ɕ
lećcie	ˈlɛt͡ɕ.t͡ɕɛ
lećmy	ˈlɛt͡ɕ.mɨ
leń	lɛɲ
leśny	ˈlɛɕ.nɨ
leśnydziadek	ˈlɛɕ.nɨ ˈd͡ʑa.dɛk
leźć	lɛɕt͡ɕ
ląd	lɔnt
lądowanie	lɔn.dɔˈva.ɲɛ
lądowisko	lɔn.dɔˈvʲi.skɔ
ma	ma
macać	ˈma.t͡sat͡ɕ
macedoński	ma.t͡sɛˈdɔɲ.skʲi
macewa	maˈt͡sɛ.va
mach	max
machać	ˈma.xat͡ɕ
machin	ma.ʃɛ̃
machina	ma.ʃi.na
macica	maˈt͡ɕi.t͡sa
maciczny	maˈt͡ɕit͡ʂ.nɨ
macie	ˈmat͡ɕɛ
maciejka	maˈt͡ɕejka
macierz	ˈma.t͡ɕɛʂ
macierzanka	ma.t͡ɕɛˈʐan.ka
macierzyński	ma.t͡ɕɛˈʐɨɲ.skʲi
macierzyństwo	ma.t͡ɕɛˈʐɨɲ.stfɔ
macocha	maˈt͡sɔ.xa
maczeta	maˈt͡ʂɛ.ta
maczuga	maˈt͡ʂu.ɡa
mag	mɑx
magazyn	maˈɡa.zɨn
magenta	məˈdʒɛntə
magia	maˈɡia
magiczny	maˈɡʲit͡ʂ.nɨ
magister	ˈmædʒɪstə(ɹ)
magisterka	ma.ɡʲiˈstɛr.ka
magisterski	ma.ɡʲiˈstɛr.skʲi
magisterskie	ma.ɡʲiˈstɛr.skʲɛ
magistra	maˈɡis.tra
magma	ˈmæɡ.mə
magnes	ˈmaɡ.neːs
magnetofon	ˈmɒɡnɛtofon
magnetowid	maɡ.nɛˈtɔ.vʲit
magnetyczny	maɡ.nɛˈtɨt͡ʂ.nɨ
magnez	ˈmaɡ.nɛs
magnolia	ˌmæɡˈnoʊ.li.ə
maj	maj
majeranek	ma.jɛˈra.nɛk
majonez	maˈjɔ.nɛs
major	ˈmeɪ.dʒə(ɹ)
majorze	maˈjɔ.ʐɛ
majowy	maˈjɔ.vɨ
majsterkowanie	maj.stɛr.kɔˈva.ɲɛ
majsterkować	maj.stɛrˈkɔ.vat͡ɕ
majtki	ˈmaj.tkʲi
maju	ˈmaju
majówka	maˈjuf.ka
mają	ˈmajɔ̃w̃
mając	ˈma.jɔnt͡s
mający	maˈjɔn.t͡sɨ
majątek	maˈjɔn.tɛk
mak	mɑk
makak	maˈkak
makaron	maˈka.rɔn
makaroniarz	ma.kaˈrɔ.ɲaʂ
makieta	maˈkʲɛ.ta
makijaż	maˈkʲi.jaʂ
makler	ˈmak.lɛr
makolągwa	makɔˈlɔŋɡva
makowiec	maˈkɔ.vʲɛt͡s
makrela	ˈmakrɛla
maksymalny	mak.sɨˈmal.nɨ
maku	ˈmɑku
malachit	maˈla.xʲit
malaria	ma.la.ʁja
malarka	maˈlar.ka
malarstwo	maˈlar.stfɔ
malarz	ˈma.laʂ
malina	maˈliː.na
malinka	maˈlʲin.ka
malinowy	ma.lʲiˈnɔ.vɨ
malowanie	ma.lɔˈva.ɲɛ
malować	maˈlɔ.vat͡ɕ
malowidło	ma.lɔˈvʲi.dwɔ
maltański	malˈtaɲ.skʲi
maluch	ˈma.lux
malując	maˈlu.jɔnt͡s
malujący	ma.luˈjɔn.t͡sɨ
malunek	maˈlu.nɛk
malutki	maˈlut.kʲi
mać	mat͡ɕ
mała	ˈmawa
małaczarna	ˈma.wa ˈt͡ʂar.na
małe	ˈmawɛ
mało	ˈmawɔ
małopolski	ma.wɔˈpɔl.skʲi
małp	mawp
małą	ˈma.wɔ̃
na	na
nabiał	ˈna.bʲaw
nabićwbutelkę	ˈna.bʲit͡ɕ vbuˈtɛl.kɛ
nabożeństwo	na.bɔˈʐɛɲ.stfɔ
nabycie	naˈbɨ.t͡ɕɛ
nabywać	naˈbɨ.vat͡ɕ
nabywca	naˈbɨf.t͡sa
nachalny	naˈxal.nɨ
nacjonalistyczny	nat͡s.jɔ.na.lʲiˈstɨt͡ʂ.nɨ
nacjonalizm	nat͡s.jɔˈna.lʲizm
naczczo	ˈnat͡ʂt͡ʂɔ
naczelnik	naˈt͡ʂɛl.ɲik
naczynie	naˈt͡ʂɨ.ɲɛ
naczyniówka	nat͡ʂɨˈɲufka
nad	nat
nadaje	naˈda.jɛ
nadajnik	naˈdaj.ɲik
nadal	ˈna.dal
nadawać	naˈda.vat͡ɕ
nadawca	naˈdaf.t͡sa
nadchodzi	natˈxɔ.d͡ʑi
nadchodzić	natˈxɔ.d͡ʑit͡ɕ
nadchodzą	natˈxɔ.d͡zɔ̃
nadczłowiek	natˈt͡ʂwɔ.vʲɛk
nade	ˈna.dɛ
nadejdzie	naˈdɛj.d͡ʑɛ
nadejść	ˈna.dɛjɕt͡ɕ
nadepnąć	naˈdɛp.nɔɲt͡ɕ
nadgarstek	nadˈɡar.stɛk
nadgorliwość	nad.ɡɔrˈlʲi.vɔɕt͡ɕ
nadmiar	ˈnad.mʲar
nadmierny	nadˈmʲɛr.nɨ
nadobny	ˈnadobn̪ɨ
nadprzewodnik	nat.pʂɛˈvɔ.dɲik
nadrobić	naˈdrɔ.bʲit͡ɕ
nadszedł	ˈnat.ʂɛdw
nadużywając	na.du.ʐɨˈva.jɔnt͡s
nadużywający	na.du.ʐɨ.vaˈjɔn.t͡sɨ
nadwabaty	na dva ˈba.tɨ
nadymać	naˈdɨ.mat͡ɕ
nadzieja	naˈd͡ʑɛ.ja
nadzieje	naˈd͡ʑɛ.jɛ
nadzieję	n̪aˈd͡ʑejɛ
nadzorca	nad͡zˈzɔr.t͡sa
nadzorować	nad.zɔˈrɔ.vat͡ɕ
nadzwyczajny	nad.zvɨˈt͡ʂaj.nɨ
nadzór	ˈnad.zur
nafta	ˈnaf.ta
naftalen	nafˈta.lɛn
nagi	ˈnaɡʲi
nagietek	naˈɡʲɛ.tɛk
nagle	ˈnaɡ.lɛ
naglący	naɡˈlɔn.t͡sɨ
nagonka	naˈɡɔn.ka
nagość	ˈna.ɡɔɕt͡ɕ
nagradzając	na.ɡraˈd͡za.jɔnt͡s
nagradzający	na.ɡra.d͡zaˈjɔn.t͡sɨ
nagradzanie	na.ɡraˈd͡za.ɲɛ
nagrobek	naˈɡrɔ.bɛk
nagroda	naˈɡrɔ.da
nagrodę	naˈɡrɔ.dɛ
nagrywarka	na.ɡrɨˈvar.ka
nagły	ˈna.ɡwɨ
nagłyprzypadek	ˈna.ɡwɨ pʂɨˈpa.dɛk
nagłówek	naˈɡwu.vɛk
nahejnał	na ˈxɛj.naw
naiwny	naˈiv.nɨ
naj	naj
najabsurdalniej	na.jap.surˈdal.ɲɛj
najabsurdalniejszy	na.jap.sur.dalˈɲɛj.ʂɨ
najadekwatniej	na.ja.dɛˈkfat.ɲɛj
najadekwatniejszy	na.ja.dɛ.kfatˈɲɛj.ʂɨ
najaktualniejszy	na.jak.tu.alˈɲɛj.ʂɨ
najaktywniejszy	na.jak.tɨvˈɲɛj.ʂɨ
najambitniejszy	na.jam.bʲitˈɲɛj.ʂɨ
najatrakcyjniejszy	na.ja.trak.t͡sɨjˈɲɛj.ʂɨ
najbanalniejszy	naj.ba.nalˈɲɛj.ʂɨ
najbardziej	n̪ajˈbarʲd͡ʑej
najbarwniejszy	naj.barˈvɲɛj.ʂɨ
najbezpieczniejszy	naj.bɛs.pʲɛt͡ʂˈɲɛj.ʂɨ
najbiedniejszy	naj.bʲɛˈdɲɛj.ʂɨ
najbielszy	najˈbʲɛl.ʂɨ
najbladszy	najˈblat.ʂɨ
najbledszy	najˈblɛt.ʂɨ
najbliższy	najˈblʲiʂ.ʂɨ
najbogatszy	naj.bɔˈɡat.ʂɨ
najbrudniej	najˈbru.dɲɛj
najbrudniejszy	naj.bruˈdɲɛj.ʂɨ
najbrutalniejszy	naj.bru.talˈɲɛj.ʂɨ
najbujniejszy	naj.bujˈɲɛj.ʂɨ
najbystrzejszy	naj.bɨˈstʂɛj.ʂɨ
najchciwszy	najˈxt͡ɕif.ʂɨ
najchudszy	najˈxut.ʂɨ
najchwalebniejszy	naj.xfa.lɛbˈɲɛj.ʂɨ
najchytrzejszy	naj.xɨtˈʂɛj.ʂɨ
najchłodniejszy	naj.xwɔˈdɲɛj.ʂɨ
najciaśniejszy	naj.t͡ɕaɕˈɲɛj.ʂɨ
najcichszy	najˈt͡ɕix.ʂɨ
najciekawiej	naj.t͡ɕɛˈka.vʲɛj
najciemniejszy	naj.t͡ɕɛmˈɲɛj.ʂɨ
najcieńszy	najˈt͡ɕɛɲ.ʂɨ
najcnotliwszy	naj.t͡snɔtˈlʲif.ʂɨ
najcudaczniejszy	naj.t͡su.dat͡ʂˈɲɛj.ʂɨ
najcudniejszy	naj.t͡suˈdɲɛj.ʂɨ
najcudowniejszy	naj.t͡su.dɔvˈɲɛj.ʂɨ
najczarniejszy	naj.t͡ʂarˈɲɛj.ʂɨ
najczerwieńszy	naj.t͡ʂɛrˈvʲɛɲ.ʂɨ
najczulszy	najˈt͡ʂul.ʂɨ
najczytelniejszy	naj.t͡ʂɨ.tɛlˈɲɛj.ʂɨ
najczęstszy	najˈt͡ʂɛ̃.stʂɨ
najdalszy	najˈdal.ʂɨ
najdawniejszy	naj.davˈɲɛj.ʂɨ
najdelikatniejszy	naj.dɛ.lʲi.katˈɲɛj.ʂɨ
najdojrzalszy	naj.dɔjˈʐal.ʂɨ
najdokładniejszy	naj.dɔ.kwaˈdɲɛj.ʂɨ
najdoroślejszy	naj.dɔ.rɔɕˈlɛj.ʂɨ
najdoskonalszy	naj.dɔ.skɔˈnal.ʂɨ
najdostępniejszy	naj.dɔ.stɛmˈpɲɛj.ʂɨ
najdowcipniej	naj.dɔfˈt͡ɕip.ɲɛj
najdrapieżniejszy	naj.dra.pʲɛʐˈɲɛj.ʂɨ
najdumniejszy	naj.dumˈɲɛj.ʂɨ
najdyskretniejszy	naj.dɨ.skrɛtˈɲɛj.ʂɨ
najdzielniejszy	naj.d͡ʑɛlˈɲɛj.ʂɨ
najdzikszy	najˈd͡ʑik.ʂɨ
najdłuższy	najˈdwuʂ.ʂɨ
najebany	na.jɛˈba.nɨ
najebaćsię	naˈjɛbat͡ɕ ɕɛ
najebka	naˈjɛp.ka
najegzotyczniejszy	na.jɛɡ.zɔ.tɨt͡ʂˈɲɛj.ʂɨ
najekologiczniejszy	na.jɛ.kɔ.lɔ.ɡʲit͡ʂˈɲɛj.ʂɨ
najemnik	naˈjɛm.ɲik
najeźdźca	na ˈjɛɕ.t͡ɕt͡sa
najeża	na ˈjɛ.ʐa
najfajniej	naˈjfaj.ɲɛj
najfajniejszy	na.jfajˈɲɛj.ʂɨ
najgorliwiej	naj.ɡɔrˈlʲi.vʲɛj
najgorliwszy	naj.ɡɔrˈlʲif.ʂɨ
najgorszy	najˈɡɔrʂɨ
najgorzej	najˈɡɔ.ʐɛj
najgoręcej	naj.ɡɔˈrɛn.t͡sɛj
najgościnniej	naj.ɡɔɕˈt͡ɕin.ɲɛj
najgrubszy	najˈɡrup.ʂɨ
najgęstszy	najˈɡɛ̃.stʂɨ
najgłodniejszy	naj.ɡwɔˈdɲɛj.ʂɨ
najgłośniejszy	naj.ɡwɔɕˈɲɛj.ʂɨ
najgłupszy	najˈɡwup.ʂɨ
najgłębszy	najˈɡwɛm.pʂɨ
najhojniejszy	naj.xɔjˈɲɛj.ʂɨ
najinteligentniejszy	na.jin.tɛ.lʲi.ɡɛnˈtɲɛj.ʂɨ
najintymniejszy	na.jin.tɨmˈɲɛj.ʂɨ
najkonkretniejszy	naj.kɔn.krɛtˈɲɛj.ʂɨ
najkoszmarniejszy	naj.kɔʂ.marˈɲɛj.ʂɨ
najkruchszy	najˈkruxʂɨ
najkruszej	najˈkru.ʂɛj
najkrwawiej	najˈkrva.vʲɛj
najkrótszy	najˈkrut.ʂɨ
najkrąglejszy	naj.krɔŋˈɡlɛj.ʂɨ
najkwaśniejszy	naj.kfaɕˈɲɛj.ʂɨ
najkłamliwiej	naj.kwamˈlʲi.vʲɛj
najlepiej	najˈlɛ.pʲɛj
najlepsiejszy	naj.lɛpˈɕɛj.ʂɨ
najlepszy	n̪ajˈlɛpʂɨ
najlichszy	najˈlʲix.ʂɨ
najliczniejszy	naj.lʲit͡ʂˈɲɛj.ʂɨ
nakońcujęzyka	na ˈkɔɲ.t͡su jɛ̃ˈzɨ.ka
nakrzywyryj	na ˈkʂɨ.vɨ rɨj
nalewąstronę	na ˈlɛ.vɔ̃ ˈstrɔ.nɛ
nanogach	na ˈnɔ.ɡax
naodwalsię	na ˈɔd.val ɕɛ
naokaziciela	na ɔ.ka.ʑiˈt͡ɕɛ.la
napamięć	na ˈpa.mʲɛɲt͡ɕ
napewno	na ˈpɛv.nɔ
napieska	na ˈpʲɛ.ska
napodwójnymgazie	na pɔdˈvuj.nɨm ˈɡa.ʑɛ
naprzykład	na ˈpʂɨ.kwat
napunkcie	na ˈpun.kt͡ɕɛ
narazie	naˈra.ʑɛ
nasetkę	na ˈsɛt.kɛ
naszybkości	na ʂɨpˈkɔɕ.t͡ɕi
natwoimmiejscu	na ˈtfɔ.im ˈmʲɛj.st͡su
nazdrowie	na ˈzdrɔ.vʲɛ
nazewnątrz	na ˈzɛv.nɔntʂ
nać	nat͡ɕ
naświętynigdy	na ˈɕfʲɛn.tɨ ˈɲiɡ.dɨ
nażądanie	na ʐɔnˈda.ɲɛ
o	o
oba	oba
obalając	ɔ.baˈla.jɔnt͡s
obalający	ɔ.ba.laˈjɔn.t͡sɨ
obalanie	ɔ.baˈla.ɲɛ
obalać	ɔˈba.lat͡ɕ
obalić	ɔˈba.lʲit͡ɕ
obaw	ˈɔ.baf
obawa	ɔˈba.va
obca	ˈɔp.t͡sa
obcas	ˈɔp.t͡sas
obchodzi	ɔpˈxɔ.d͡ʑi
obciach	ˈɔp.t͡ɕax
obciążać	ɔpˈt͡ɕɔŋ.ʐat͡ɕ
obciążenie	ɔp.t͡ɕɔŋˈʐɛ.ɲɛ
obcokrajowiec	ɔp.t͡sɔ.kraˈjɔ.vʲɛt͡s
obcować	ɔpˈt͡sɔ.vat͡ɕ
obcy	ˈɔp.t͡sɨ
obcęgi	ɔpˈt͡sɛŋ.ɡʲi
obecnie	ɔˈbɛt͡s.ɲɛ
obecność	ɔˈbɛt͡s.nɔɕt͡ɕ
obecny	ɔˈbɛt͡s.nɨ
obejmowanie	ɔ.bɛj.mɔˈva.ɲɛ
obejmować	ɔ.bɛjˈmɔ.vat͡ɕ
obejmując	ɔ.bɛjˈmu.jɔnt͡s
obejmujący	ɔ.bɛj.muˈjɔn.t͡sɨ
obelga	ɔˈbɛl.ɡa
obelisk	ɔˈbɛ.lʲisk
obficie	ɔpˈfʲi.t͡ɕɛ
obfitość	ɔpˈfʲi.tɔɕt͡ɕ
obfitszy	ɔpˈfʲit.ʂɨ
obfity	ɔpˈfʲi.tɨ
obgadać	ɔbˈɡa.dat͡ɕ
obgadywać	ɔb.ɡaˈdɨ.vat͡ɕ
obiad	ˈɔ.bʲat
obiecadło	ɔ.bʲɛˈt͡sa.dwɔ
obiecanie	ɔ.bʲɛˈt͡sa.ɲɛ
obiecankicacanki	ɔ.bʲɛˈt͡san.kʲi t͡saˈt͡san.kʲi
obiecać	ɔˈbʲɛ.t͡sat͡ɕ
obiecuje	ɔbʲjɛˈt͡s̪ujɛ
obiecuję	ɔbʲjɛˈt͡s̪ujɛ
obiecywać	ɔ.bʲɛˈt͡sɨ.vat͡ɕ
obiecywaćgruszkinawierzbie	ɔ.bʲɛˈt͡sɨ.vat͡ɕ ˈɡruʂ.kʲi na ˈvʲɛʐ.bʲɛ
obiecywaćzłotegóry	ɔ.bʲɛˈt͡sɨ.vat͡ɕ ˈzwɔ.tɛ ˈɡu.rɨ
obiekt	ˈɔ.bʲɛkt
obiektyw	ɔˈbʲɛk.tɨf
obiektywny	ɔ.bʲɛkˈtɨv.nɨ
obiektywszerokokątny	ɔˈbʲɛk.tɨf ʂɛ.rɔ.kɔˈkɔn.tnɨ
obietnica	ɔ.bʲɛtˈɲi.t͡sa
objaw	ˈɔ.bʲaf
objętość	ɔˈbʲɛn.tɔɕt͡ɕ
oblekać	ɔbˈlɛ.kat͡ɕ
oblicze	ɔbˈlʲi.t͡ʂɛ
obligacja	ɔb.lʲiˈɡat͡s.ja
oblężenie	ɔb.lɛŋˈʐɛ.ɲɛ
obnosić	ɔbˈnɔ.ɕit͡ɕ
oboczność	ɔˈbɔt͡ʂ.nɔɕt͡ɕ
obojczyk	ɔˈbɔjt͡ʂɨk
oboje	ɔˈbɔ.jɛ
obojętność	ɔ.bɔˈjɛn.tnɔɕt͡ɕ
obojętny	ɔ.bɔˈjɛn.tnɨ
obok	ˈɔ.bɔk
obora	ɔˈbɔ.ra
obowiązek	ɔ.bɔˈvʲɔ̃.zɛk
obrabować	ɔ.braˈbɔ.vat͡ɕ
obracać	ɔˈbra.t͡sat͡ɕ
obraz	ˈobras
obrazić	ɔˈbra.ʑit͡ɕ
obrazoburca	ɔ.bra.zɔˈbur.t͡sa
obraźliwy	ɔ.braʑˈlʲi.vɨ
obrażając	ɔ.braˈʐa.jɔnt͡s
obrażający	ɔ.bra.ʐaˈjɔn.t͡sɨ
obrażać	ɔˈbra.ʐat͡ɕ
obrażenie	ɔ.braˈʐɛ.ɲɛ
obrona	ɔˈbrɔ.na
obrony	ɔˈbrɔ.nɨ
obroża	ɔˈbrɔ.ʐa
obrus	ˈɔ.brus
obrzezać	ɔbˈʐɛ.zat͡ɕ
obrzydliwiebogaty	ɔb.ʐɨdˈlʲi.vʲɛ bɔˈɡa.tɨ
obrzęk	ˈɔb.ʐɛŋk
obrzęknąć	ɔbˈʐɛŋ.knɔɲt͡ɕ
obrót	ˈɔ.brut
obręcz	ˈɔ.brɛnt͡ʂ
obserwować	ɔp.sɛrˈvɔ.vat͡ɕ
obserwując	ɔp.sɛrˈvu.jɔnt͡s
obserwujący	ɔp.sɛr.vuˈjɔn.t͡sɨ
obsesja	ɔpˈsɛs.ja
obsesyjnie	ɔp.sɛˈsɨj.ɲɛ
obsesyjny	ɔp.sɛˈsɨj.nɨ
obszar	ˈɔp.ʂar
obszerniejszy	ɔp.ʂɛrˈɲɛj.ʂɨ
obszerny	ɔpˈʂɛr.nɨ
obudowa	ɔ.buˈdɔ.va
obudzić	ɔˈbu.d͡ʑit͡ɕ
obudź	ˈɔ.but͡ɕ
oburęczny	ɔ.buˈrɛn.t͡ʂnɨ
obuwie	ɔˈbu.vʲɛ
obuć	ˈɔ.but͡ɕ
obwiniać	ɔbˈvʲi.ɲat͡ɕ
obwodnica	ɔb.vɔˈdɲi.t͡sa
obwód	ˈɔb.vut
obywatel	ɔ.bɨˈva.tɛl
obywatelka	ɔ.bɨ.vaˈtɛl.ka
obywatelstwo	ɔ.bɨ.vaˈtɛl.stfɔ
obój	ˈobuj
obóz	ˈɔ.bus
obózkoncentracyjny	ˈɔ.bus kɔn.t͡sɛn.traˈt͡sɨj.nɨ
obłok	ˈɔ.bwɔk
obłość	ˈɔ.bwɔɕt͡ɕ
obły	ˈɔ.bwɨ
obłąkany	ɔbwɔ̃ŋˈkãn̪ɨ
obżarstwo	ɔbˈʐar.stfɔ
ocalić	ɔˈt͡sa.lʲit͡ɕ
ocean	ˈəʊ.ʃən
ocena	ɔˈt͡sɛ.na
oceniać	ɔˈt͡sɛ.ɲat͡ɕ
ocenić	ɔˈt͡sɛ.ɲit͡ɕ
ocet	ˈot͡sɛt
ochota	ɔˈxɔ.ta
ochotniczastrażpożarna	ɔ.xɔtˈɲi.t͡ʂa straʂ pɔˈʐar.na
ochotnik	ɔˈxɔt.ɲik
ochoty	ɔˈxɔ.tɨ
ochotę	ɔˈxɔ.tɛ
ochrona	ɔˈxrɔ.na
ochroniarz	ɔˈxrɔ.ɲaʂ
ochronny	ɔˈxrɔn.nɨ
ochrony	ɔˈxrɔ.nɨ
ochronę	ɔˈxrɔ.nɛ
ocieplać	ɔˈt͡ɕɛp.lat͡ɕ
ocipieć	ɔˈt͡ɕi.pʲɛt͡ɕ
oczach	ˈɔ.t͡ʂax
oczami	ɔˈt͡ʂa.mʲi
oczekuje	ɔ.t͡ʂɛˈku.jɛ
oczekuję	ɔ.t͡ʂɛˈku.jɛ
oczeret	ɔˈt͡ʂɛ.rɛt
oczerniać	ɔˈt͡ʂɛr.ɲat͡ɕ
oczko	ˈɔt͡ʂ.kɔ
oczojebny	ɔ.t͡ʂɔˈjɛb.nɨ
oczom	ˈɔ.t͡ʂɔm
oczu	ˈɔ.t͡ʂu
oczy	ɔt͡ʂɨ
oczyma	ɔˈt͡ʂɨ.ma
oczywistość	ɔ.t͡ʂɨˈvʲi.stɔɕt͡ɕ
oczywistszy	ɔ.t͡ʂɨˈvʲi.stʂɨ
oczywisty	ɔ.t͡ʂɨˈvʲi.stɨ
oczywiście	ɔ.t͡ʂɨˈvʲiɕ.t͡ɕɛ
oczęta	ɔˈt͡ʂɛ̃n̪t̪a
od	ɒd
oda	ˈodɒ
odbiegać	ɔdˈbʲɛ.ɡat͡ɕ
odbiera	ɔdˈbʲɛ.ra
odbierać	ɔdˈbʲɛ.rat͡ɕ
odbierz	ˈɔd.bʲɛʂ
odbijać	ɔdˈbʲi.jat͡ɕ
odbiornik	ɔdˈbʲɔr.ɲik
odbiór	ˈɔd.bʲur
odbić	ˈɔd.bʲit͡ɕ
odbiło	ɔdˈbʲi.wɔ
odbudować	ɔdbuˈdɔvat͡ɕ
odbyt	ˈɔd.bɨt
odchody	ɔtˈxɔ.dɨ
odchodzić	ɔtˈxɔ.d͡ʑit͡ɕ
odchodzę	ɔtˈxɔ.d͡zɛ
odchodź	ˈɔt.xɔt͡ɕ
odcień	ˈɔt.t͡ɕɛɲ
odcinek	ɔtˈt͡ɕi.nɛk
odczasownikowy	ɔt.t͡ʂaˌsɔv.ɲiˈkɔ.vɨ
odczasukiedy	ɔt ˈt͡ʂa.su ˈkʲɛ.dɨ
odczynić	ɔtˈt͡ʂɨ.ɲit͡ɕ
oddaj	ˈɔd.daj
oddać	ˈɔd.dat͡ɕ
odrazu	ɔˈdra.zu
odręki	ɔdˈrɛ.kʲi
okantdupypotłuc	ɔ kant ˈdu.pɨ ˈpɔ.twut͡s
owilkumowa	ɔ ˈvʲil.ku ˈmɔ.va
owilkumowa,awilktu	ɔ ˈvʲil.ku ˈmɔ.va a ˈvʲilk ˈtu
pa	pɑː
pacan	ˈpa.t͡san
pacha	ˈpaxa
pachnidło	paxˈɲi.dwɔ
pachnie	ˈpax.ɲɛ
pachnieć	ˈpax.ɲɛt͡ɕ
pachołek	paˈxɔ.wɛk
pacjent	ˈpat͡s.jɛnt
pacjenta	pat͡sˈjɛn.ta
pacjentka	pat͡sˈjɛn.tka
pacjentów	pat͡sˈjɛn.tuf
paczka	ˈpat͡ʂ.ka
paczyć	ˈpa.t͡ʂɨt͡ɕ
padaczka	paˈdat͡ʂ.ka
padaczkowy	pa.dat͡ʂˈkɔ.vɨ
padający	pa.daˈjɔn.t͡sɨ
padanie	paˈda.ɲɛ
padać	ˈpadat͡ɕ
padnij	ˈpa.dɲij
padnięty	paˈdɲɛn.tɨ
pagórek	paˈɡu.rɛk
pajac	ˈpa.jat͡s
pajączek	paˈjɔ̃nt͡ʂɛk
pająk	ˈpa.jɔŋk
pakować	paˈkɔ.vat͡ɕ
pakunek	paˈku.nɛk
pal	pal
palacz	ˈpalat͡ʂ
palant	ˈpa.lant
palarnia	paˈlar.ɲa
palatalizacja	palataliˈzat͡sja
palcie	ˈpal.t͡ɕɛ
palców	ˈpal.t͡suf
palcówka	palˈt͡suf.ka
palec	ˈpalɛt͡s
palenie	paˈlɛ.ɲɛ
palenisko	pa.lɛˈɲi.skɔ
paleontolog	pa.lɛ.ɔnˈtɔ.lɔk
palestyński	pa.lɛˈstɨɲ.skʲi
palgosześć	pal ɡɔ ʂɛɕt͡ɕ
pali	ˈpalʲi
palicie	paˈlʲi.t͡ɕɛ
palimy	paˈlʲi.mɨ
palindrom	paˈlʲin.drɔm
palisada	pa.lʲiˈsa.da
palisz	ˈpa.lʲiʂ
paliwo	paˈlʲi.vɔ
palić	ˈpa.lʲit͡ɕ
palićsię	ˈpa.lʲit͡ɕ ɕɛ
palił	ˈpalʲiw
paliła	paˈlʲi.wa
paliłaby	pa.lʲiˈwa.bɨ
paliłabym	pa.lʲiˈwa.bɨm
paliłabyś	pa.lʲiˈwa.bɨɕ
paliłam	paˈlʲi.wam
paliłaś	paˈlʲi.waɕ
paliłby	paˈlʲiw.bɨ
paliłbym	paˈlʲiw.bɨm
paliłbyś	paˈlʲiw.bɨɕ
paliłem	paˈlʲi.wɛm
paliłeś	paˈlʲi.wɛɕ
paliło	paˈlʲi.wɔ
paliłoby	pa.lʲiˈwɔ.bɨ
pallad	ˈpal.lat
palma	ˈpal.mə
palmowy	palˈmɔ.vɨ
palnik	ˈpal.ɲik
palny	ˈpal.nɨ
palono	paˈlɔ.nɔ
palsześć	pal ʂɛɕt͡ɕ
pamiątka	paˈmʲɔn.tka
pamiętający	pa.mʲɛn.taˈjɔn.t͡sɨ
pamiętam	pãˈmʲjɛ̃n̪t̪ãm
pamiętamy	pa.mʲɛnˈta.mɨ
pamiętasz	pãˈmʲjɛ̃n̪t̪aʂ
pamiętać	paˈmʲɛn.tat͡ɕ
pamiętliwy	pa.mʲɛnˈtlʲi.vɨ
pamiętnik	pãˈmʲjɛ̃n̪t̪ʲɲik
pamiętny	paˈmʲɛn.tnɨ
pamięć	ˈpa.mʲɛɲt͡ɕ
pan	pæn
pana	ˈpana
panach	ˈpa.nax
panami	paˈna.mʲi
pancerz	ˈpan.t͡sɛʂ
pandeista	pan.dɛˈi.sta
pandeizm	panˈdɛ.izm
pandemia	panˈdɛ.mʲa
panem	ˈpanɛm
pani	ˈpa.ɲi
paniach	ˈpa.ɲax
panie	ˈpa.ɲɛ
panienko	paˈɲɛn.kɔ
panika	ˈpa.ɲi.ka
panią	ˈpa.ɲɔ̃
panna	ˈpana
panom	ˈpa.nɔm
panorama	ˌpæ.nəˈɹæ.mə
panować	paˈnɔ.vat͡ɕ
panowie	paˈnɔ.vʲɛ
panpsychizm	panˈpsɨ.xʲizm
panteista	pan.tɛˈi.sta
panteizm	panˈtɛ.izm
pantograf	panˈtɔ.ɡraf
panu	ˈpanu
panwładza	pan ˈvwa.d͡za
panów	ˈpa.nuf
papa	pəˈpɑː
papier	pa.pje
papierek	paˈpʲɛ.rɛk
papieros	paˈpʲɛ.rɔs
papierowy	papjɛˈrɔvɨ
papierośnica	pa.pʲɛ.rɔɕˈɲi.t͡sa
papiery	paˈpʲɛ.rɨ
papieski	paˈpʲɛs.kʲi
papież	ˈpa.pʲɛʂ
paproć	ˈpaprɔt͡ɕ
papryka	paˈprɨ.ka
papuga	paˈpu.ɡa
papużka	paˈpuʂka
papużkafalista	paˈpuʂ.ka faˈlʲi.sta
para	ˈpɑːɹə
parabola	pəˈɹæbələ
paradoks	pʰɑɑˈd̥ʌɡ̊s
paradoksalny	pa.ra.dɔkˈsal.nɨ
paradygmat	pa.raˈdɨɡ.mat
parafia	paˈra.fʲa
parafianin	pa.raˈfʲa.ɲin
paragon	ˈpæɹəɡən
paragraf	paˈra.ɡraf
pałac	ˈpa.wat͡s
pałaszować	pa.waˈʂɔ.vat͡ɕ
pałka	ˈpawka
pałować	paˈwɔ.vat͡ɕ
pały	ˈpawɨ
pańska	ˈpaɲ.ska
państwa	ˈpaɲ.stfa
państwo	ˈpaɲ.stfɔ
raban	ˈrapan
rabat	ˈrapah(t)
rabować	raˈbɔ.vat͡ɕ
rabunek	raˈbunɛk
raca	ˈra.t͡sa
rachityczny	ra.xʲiˈtɨt͡ʂ.nɨ
rachować	raˈxɔ.vat͡ɕ
rachunek	raˈxun̪ɛk
rachunkowość	ra.xunˈkɔ.vɔɕt͡ɕ
racica	raˈt͡ɕit͡s̪a
racjonalizm	rat͡s.jɔˈna.lʲizm
rację	ˈrat͡s̪ʲjɛ
raczej	ˈra.t͡ʂɛj
raczyć	ˈra.t͡ʂɨt͡ɕ
rad	ɹæd
rada	ˈrada
radio	ˈɹeɪdiˌəʊ
radiowy	raˈdjɔvɨ
radlica	radˈlʲi.t͡sa
radna	ˈrad.na
radni	ˈra.dɲi
radny	ˈrad.nɨ
radon	ˈɹeɪdɒn
radosny	raˈdɔs.nɨ
radości	raˈdɔɕ.t͡ɕi
radośnie	raˈdɔɕ.ɲɛ
radość	ˈra.dɔɕt͡ɕ
radziecki	raˈd͡ʑɛt͡s.kʲi
radzisz	ˈra.d͡ʑiʂ
radzę	ˈra.d͡zɛ
radę	ˈrad̪ɛ
rafa	ˈrafa
rafandynka	ra.fanˈdɨn.ka
raj	ɹɑːdʒ
rajdowiec	rajˈdɔ.vʲɛt͡s
rajpodatkowy	raj pɔ.datˈkɔ.vɨ
rajski	ˈraj.skʲi
rajstopy	rajˈstɔpɨ
rak	rak
rakach	ˈrakax
rakami	raˈka.mʲi
rakiem	ˈra.kʲɛm
rakieta	raˈkʲɛ.ta
rakietaśnieżna	raˈkʲɛ.ta ˈɕɲɛʐ.na
rakom	ˈra.kɔm
rakotwórczy	ra.kɔˈtfur.t͡ʂɨ
rakowi	raˈkɔ.vʲi
raków	ˈra.kuf
ramka	ˈram.ka
ramol	ˈra.mɔl
rana	ˈraː.na
randka	ˈrantka
ranny	ˈran.nɨ
rannyptaszek	ˈran.nɨ ˈpta.ʂɛk
rano	ˈrano
rany	ˈra.nɨ
rasista	raˈɕi.sta
rasizm	ˈraɕis̪m̥
rataj	ˈra.taj
ratownik	raˈtɔv.ɲik
ratrak	ˈra.trak
ratujący	ra.tuˈjɔn.t͡sɨ
ratunek	raˈtu.nɛk
ratusz	ˈratuʂ
raz	ʁa
razem	ˈraz̪ɛm
razie	ˈraʑɛ
razić	ˈra.ʑit͡ɕ
raznaruskirok	ras na ˈrus.kʲi rɔk
razu	ˈrazu
razy	ˈraz̪ɨ
rdza	rd͡za
rdzawy	ˈrd͡za.vɨ
rdzeń	rd͡zɛɲ
rdzeńkręgowy	rd͡zɛɲ krɛŋˈɡɔ.vɨ
reagować	rɛ.aˈɡɔ.vat͡ɕ
reakcyjny	rɛ.akˈt͡sɨj.nɨ
realista	rɛ.aˈlʲi.sta
realistyczniejszy	rɛ.a.lʲi.stɨt͡ʂˈɲɛj.ʂɨ
realizujący	rɛ.a.lʲi.zuˈjɔn.t͡sɨ
recepcja	rɛˈt͡sɛp.t͡sja
red	ɹɛd
redakcja	rɛˈdak.t͡sja
refujący	rɛ.fuˈjɔn.t͡sɨ
regał	ˈrɛ.ɡaw
region	ˈɹiːd͡ʒn̩
regionem	rɛˈɡʲɔ.nɛm
regulaminowyczas	rɛɡulamʲiˈnɔvɨ t͡ʂas
regularniejszy	rɛ.ɡu.larˈɲɛj.ʂɨ
reguła	rɛˈɡu.wa
regułaprzekory	rɛˈɡu.wa pʂɛˈkɔ.rɨ
reizm	ˈrɛ.izm
rejestr	ˈrɛjɛs̪t̪r̥
rejestracja	rɛjɛˈstrat͡sʲja
rekin	ˈrɛ.kʲin
reklamowana	rɛk.la.mɔˈva.na
reklamowane	rɛk.la.mɔˈva.nɛ
reklamowani	rɛk.la.mɔˈva.ɲi
reklamowany	rɛk.la.mɔˈva.nɨ
reklamujący	rɛk.la.muˈjɔn.t͡sɨ
rekord	ˈrɛkord
relacja	rɛˈlat͡s.ja
religia	rɛˈlʲiɟja
relikwiarz	rɛˈlʲik.fʲaʂ
remis	ˈrɛmʲis
ren	ɹɛn
rena	ˈrɛ.na
rendezvous	ʁɑ̃.de.vu
renegat	rɛˈnɛ.ɡat
renem	ˈrɛ.nɛm
renie	ˈrɛ.ɲɛ
renifer	rɛˈɲi.fɛr
renom	ˈrɛ.nɔm
renta	ˈrɛn.ta
rentgen	ˈrɛn.tɡɛn
reportaż	rɛˈpɔrtaʂ
repozytorium	rɛ.pɔ.zɨˈtɔ.rʲum
reprezentant	rɛ.prɛˈzɛn.tant
reputacja	rɛpuˈtat͡sja
restauracja	rɛstawˈrat͡sja
reszta	ˈrɛʂta
resztka	ˈrɛʂ.tka
resztki	ˈrɛʂ.tkʲi
reszty	ˈrɛʂ.tɨ
resztynietrzeba	ˈrɛʂ.tɨ ɲɛ ˈtʂɛ.ba
resztą	ˈrɛʂ.tɔ̃
rewers	ˈrɛ.vɛrs
rewolucja	rɛvɔˈlut͡sja
rewolwer	rɛˈvɔlvɛr
rezerwujący	rɛ.zɛr.vuˈjɔn.t͡sɨ
rezun	ˈrɛ.zun
rezus	ˈrɛ.zus
reżyser	rɛˈʐɨsɛr
rąbać	ˈrɔm.bat͡ɕ
rączka	ˈrɔn.t͡ʂka
rąk	rɔŋk
ręce	ˈrɛ̃n̪t͡s̪ɛ
ręcznik	ˈrɛ̃nt͡ʂɲik
ręka	ˈrɛŋka
rękach	ˈrɛŋ.kax
rękawica	rɛ̃ŋkaˈvʲit͡s̪a
rękawiczka	rɛŋkaˈvʲit͡ʂka
ręki	ˈrɛŋ.kʲi
ręko	ˈrɛŋ.kɔ
ręką	ˈrɛŋ.kɔ̃
rękę	ˈrɛ̃ŋkɛ
sabotaż	s̪aˈbɔt̪aʂ
sabotujący	sa.bɔ.tuˈjɔn.t͡sɨ
sacharyna	sa.xaˈrɨ.na
sad	sæd
sadza	ˈsad͡za
sadzawka	saˈd͡zaf.ka
sadzić	ˈsa.d͡ʑit͡ɕ
sadzonka	saˈd͡zɔn.ka
sadło	ˈsadwɔ
sagan	ˈsa.ɡan
sajgon	ˈsaj.ɡɔn
sajgonka	sajˈɡɔn.ka
sajonara	sa.jɔˈna.ra
sake	seɪk
saksofonista	sak.sɔ.fɔˈɲi.sta
sala	ˈsala
saletra	saˈlɛ.tra
salon	səˈlɒn
sam	sæm
samar	ˈsa.mar
samica	saˈmʲi.t͡sa
samiec	ˈsa.mʲɛt͡s
samobójca	samɔˈbujt͡sa
samobójstwo	samɔˈbujstfɔ
samochodem	sa.mɔˈxɔ.dɛm
samochody	samɔˈxɔdɨ
samochodzie	sa.mɔˈxɔ.d͡ʑɛ
samochód	s̪aˈmɔxut̪
samodzielny	sa.mɔˈd͡ʑɛl.nɨ
samogon	saˈmɔ.ɡɔn
samogłoska	samɔˈɡwɔska
samojebka	sa.mɔˈjɛp.ka
samolocie	sa.mɔˈlɔ.t͡ɕɛ
samolotbezzałogowy	saˈmɔ.lɔt bɛz.za.wɔˈɡɔ.vɨ
samolotu	sa.mɔˈlɔ.tu
samoloty	sa.mɔˈlɔ.tɨ
samolubny	sa.mɔˈlub.nɨ
samorzutnie	sa.mɔˈʐut.ɲɛ
samorzutny	sa.mɔˈʐut.nɨ
samostrzał	saˈmɔ.stʂaw
samosąd	saˈmɔ.sɔnt
samotniejszy	sa.mɔtˈɲɛj.ʂɨ
samotnik	saˈmɔt.ɲik
samotność	s̪äˈmɔtn̪ɔɕt͡ɕ
samotny	saˈmɔt.nɨ
samouk	saˈmɔ.uk
samozaoranie	sa.mɔ.za.ɔˈra.ɲɛ
samozwaniec	sa.mɔzˈva.ɲɛt͡s
samt	samt
samuraj	saˈmuraj
sanki	ˈs̪an̪kʲi
sanskrycki	sanˈskrɨt͡s.kʲi
sanskryt	ˈsan.skrɨt
sapać	ˈsa.pat͡ɕ
sardynka	sarˈdɨnka
sarkać	ˈsar.kat͡ɕ
sarkofagi	s̪arkɔˈfaɟi
sarna	ˈsarna
sarniak	ˈsar.ɲak
satanista	sa.taˈɲi.sta
satrapa	ˈsa.tra.pa
sauna	ˈsɔː.nə
sałata	saˈwata
sałatka	saˈwat ka
scenarzysta	st͡sɛ.naˈʐɨ.sta
scenę	ˈst͡sɛ.nɛ
schab	sxap
schabowy	sxaˈbɔ.vɨ
schadzka	ˈsxat͡s.ka
schizma	ˈsxʲiz.ma
schizofrenia	sxʲi.zɔˈfrɛ.ɲa
schlebiający	sxlɛ.bʲaˈjɔn.t͡sɨ
schnąć	sxnɔɲt͡ɕ
schorzenie	sxɔˈʐɛ.ɲɛ
schowaj	ˈsxɔ.vaj
schować	ˈsxɔ.vat͡ɕ
schowek	ˈsxɔ.vɛk
schronisko	sxrɔˈɲi.skɔ
schyłek	ˈsxɨ.wɛk
sciencefiction	ˈsaɪəns ˌfɪkʃən
scyzoryk	st͡sɨˈzɔ.rɨk
seaborg	ˈsɨ.bɔrk
sedno	ˈsɛd.nɔ
sejf	sɛɪ̯f
sejmik	ˈsɛj.mʲik
seks	sɛks
seksoralny	sɛks ɔˈral.nɨ
sekta	ˈsɛk.ta
sektasmoleńska	ˈsɛk.ta smɔˈlɛɲ.ska
sekund	seˈkʊnt
sekunda	s̪ɛˈkun̪d̪a
sekundy	sɛˈkun.dɨ
sekundę	sɛˈkun.dɛ
selen	ˈsɛ.lɛn
selenocysteina	sɛ.lɛ.nɔ.t͡sɨ.stɛˈi.na
semantyczny	sɛ.manˈtɨt͡ʂ.nɨ
semestr	ˈsɛ.mɛstr
seminarzysta	sɛ.mʲi.naˈʐɨ.sta
sen	sɛn
senior	ˈsinjɚ
seniora	sɛˈɲɔ.ra
seniorem	sɛˈɲɔ.rɛm
sens	sɑ̃s
sensacja	sɛnˈsat͡s.ja
sensacyjny	sɛn.saˈt͡sɨj.nɨ
sensie	ˈsɛn.ɕɛ
senzimowy	sɛn ʑiˈmɔ.vɨ
ser	ˈse
serbiały	sɛr ˈbʲa.wɨ
serbski	ˈsɛrskʲi
serc	sʲerk
serca	ˈsɛrt͡sa
sercach	ˈsɛrt͡sax
serce	ˈs̪ɛrt͡s̪ɛ
sercem	ˈsɛr.t͡sɛm
sercu	ˈsɛr.t͡su
serduszko	sɛrˈduʂ.kɔ
seriarzutówkarnych	ˈsɛrʲja ˈʐutuf ˈkarnɨx
serio	ˈsɛ.rʲɔ
sernik	ˈs̪ɛrɲik
sertopiony	sɛr tɔˈpʲɔ.nɨ
serwatka	sɛrˈvat.ka
serwerownia	sɛr.vɛˈrɔv.ɲa
są	s̪ɔ̃w̃
sączyć	ˈsɔn.t͡ʂɨt͡ɕ
sąd	sɔnt
sądu	ˈsɔn.du
sądzi	ˈsɔɲ.d͡ʑi
sądzie	ˈsɔɲ.d͡ʑɛ
sądzisz	ˈs̪ɔ̃ɲd͡ʑiʂ
sądzić	ˈsɔɲ.d͡ʑit͡ɕ
sądziłam	sɔɲˈd͡ʑi.wam
sądziłem	sɔɲˈd͡ʑi.wɛm
sądzę	ˈs̪ɔ̃n̪d͡z̪ɛ
sąg	s̪ɔ̃ŋk
sąsiad	ˈsɔ̃ɕat
sąsiedztwo	sɔɲˈɕɛt͡s.tfɔ
sążny	ˈsɔŋ.ʐnɨ
ta	tɑː
tabaka	tabaka
tabela	taˈbɛla
tablica	tabˈlʲi.t͡sa
tablicaMendelejewa	tabˈlʲi.t͡sa mɛn.dɛ.lɛˈjɛ.va
tabliczka	tabˈlʲit͡ʂ.ka
tabliczkamnożenia	tabˈlʲit͡ʂ.ka mnɔˈʐɛ.ɲa
tabloid	tabˈlɔ.it
tabloidy	tab.lɔˈi.dɨ
tabor	ˈta.bɔr
taboret	ˈtæbəɹɛt
taca	ˈta.kə
tachykardia	t̪axɨˈkard̪ja
tacierzyński	ta.t͡ɕɛˈʐɨɲ.skʲi
tacy	ˈta.t͡sɨ
taczka	ˈtat͡ʂka
tafla	ˈtʰapla
taić	ˈta.it͡ɕ
tajać	ˈta.jat͡ɕ
tajemnicy	ta.jɛmˈɲi.t͡sɨ
tajlandzki	t̪ajˈlan̪t͡s̪kʲi
tajniejszy	tajˈɲɛj.ʂɨ
tajnik	ˈtaj.ɲik
tajny	ˈtajnɨ
tajski	ˈt̪ajs̪kʲi
tak	tak
taka	ˈtʰɛaːʰka
taki	ˈt̪aci
takiej	ˈta.kʲɛj
takiemu	taˈkʲɛ.mu
taksówka	taˈksufka
taksówkarz	taˈksufkaʂ
taką	ˈta.kɔ̃
także	ˈta.ɡʐɛ
tal	ˈtal
talar	ˈtalar
talent	ˈtælənt
talerz	ˈta.lɛʂ
talon	ˈtælən
talonnabalon	ˈta.lɔn na ˈba.lɔn
tam	tam
tama	ˈta.ma
tamci	ˈtam.t͡ɕi
tamten	ˈtamtɛn
tanatopraksja	ta.na.tɔˈprak.sja
tandeta	tanˈdɛ.ta
tandetny	tanˈdɛt.nɨ
tani	taˈni
taniec	ˈtaɲɛt͡s
taniocha	taˈɲɔ.xa
tankowiec	tanˈkɔ.vʲɛt͡s
tantal	ˈtan.tal
taon	tɑ̃
tapeta	taˈpɛta
taran	tʰaˈraŋ
taras	tàra̋-s
tarcza	ˈt̪art͡ʂa
targ	tark
targać	ˈtar.ɡat͡ɕ
targi	ˈtar.ɡʲi
tarka	ˈtɒrkɒ
tartak	ˈtar.tak
tasak	ˈtɒʃɒk
tata	tɑtɑ
taternik	taˈtɛr.ɲik
tato	ˈt̪at̪ɔ
tatuaż	taˈtuaʂ
tatusia	taˈtu.ɕa
tatusiu	taˈtu.ɕu
tatuujący	ta.tu.uˈjɔn.t͡sɨ
tatuś	ˈt̪at̪uɕ
taty	ˈta.tɨ
tatą	ˈta.tɔ̃
tatę	ˈta.tɛ
tańczyć	ˈt̪ãĩ̯nt͡ʂɨt͡ɕ
tańsi	ˈt̪ãĩ̯ɕi
taśma	ˈtaɕ.ma
taśmę	ˈtaɕ.mɛ
tchórz	txuʂ
te	tiː
teatr	ˈt̪ɛat̪r̥
technet	ˈtɛx.nɛt
techniczny	tɛxˈɲit͡ʂnɨ
techno	tɛk.no
tedy	ˈtɛ.dɨ
tego	ˈte.ɡoː
teista	ˈtʰeista
tej	ˈtɛd͡ʒ
teks	tɛks
tektura	tɛkˈtu.ra
tekturafalista	tɛkˈtu.ra faˈlʲi.sta
tekściarz	ˈtɛk.ɕt͡ɕaʂ
telefon	ˈtɛlɛfon
telefoniczny	tɛlɛfɔˈɲit͡ʂnɨ
telefonkomórkowy	tɛˈlɛfɔn kɔmurˈkɔvɨ
telefonnakartę	tɛˈlɛ.fɔn na ˈkar.tɛ
telefonowi	tɛ.lɛ.fɔˈnɔ.vʲi
telefonujący	tɛ.lɛ.fɔ.nuˈjɔn.t͡sɨ
telefony	tɛ.lɛˈfɔ.nɨ
telefonów	tɛ.lɛˈfɔ.nuf
telegrafować	tɛ.lɛ.ɡraˈfɔ.vat͡ɕ
telekom	tɛˈlɛ.kɔm
telenowela	tɛ.lɛ.nɔˈvɛ.la
teleobiektyw	tɛ.lɛ.ɔˈbʲɛk.tɨf
teleturniej	tɛ.lɛˈtur.ɲɛj
telewizja	tɛlɛˈvizja
telewizor	tɛlɛˈvʲizɔr
tellur	ˈtɛ.lʊr
temat	ˈtɛmat
temblak	ˈtɛm.blak
temperatura	tem.pe.raːˈtuː.ra
temperówka	ˌtɛmpɛˈɾufka
tempo	ˈtɛm.pəʊ
tempomat	tɛmˈpɔ.mat
temu	ˈtɛ.mu
ten	tɛn
tender	ˈtɛn.də(ɹ)
tenisista	tɛ.ɲiˈɕi.sta
tenisistka	t̪ɛɲiˈɕis̪t̪ka
tenisówka	tɛ.ɲiˈsuf.ka
tenisówki	tɛ.ɲiˈsuf.kʲi
teoria	ˈteoriɑ
terapia	t̪ɛˈrapja
teraz	ˈtɛras
teraźniejszy	tɛ.raʑˈɲɛj.ʂɨ
terb	tɛrp
terenie	tɛˈrɛ.ɲɛ
terkotka	tɛrˈkɔt.ka
termin	tɛrmiːn
terrorysta	tɛ.rrɔˈrɨ.sta
test	tɛst
testament	ˈtɛst.ə.mənt
teściowa	tɛɕˈt͡ɕɔva
teść	tɛɕt͡ɕ
też	tɛʂ
tir	tiʁ
tiramisu	ˌtɪɹəmɪˈsuː
tirówka	tiˈruf.ka
tkacz	tkat͡ʂ
tkaczka	ˈtkat͡ʂ.ka
tkający	tkaˈjɔn.t͡sɨ
tkanka	ˈtkan.ka
tkać	tkat͡ɕ
tlen	tlɛn
tleć	tlɛt͡ɕ
tą	tɔ̃
tę	tɛ
tęcza	ˈt̪ɛnt͡ʂa
tęczówka	t̪ɛ̃nˈt͡ʂufka
tędy	ˈt̪ɛ̃n̪d̪ɨ
tęgi	ˈtɛŋ.ɡʲi
tępy	ˈt̪ɛmpɨ
tęsknić	ˈt̪ɛ̃s̪cɲit͡ɕ
tęsknię	ˈtɛ̃.skɲɛ
tętnica	tɛnˈtɲi.t͡sa
tężec	ˈtɛŋ.ʐɛt͡s
tłoczyć	ˈtwɔ.t͡ʂɨt͡ɕ
tłok	twɔk
tłuc	twut͡s
tłuczek	ˈtwu.t͡ʂɛk
tłukno	ˈtwuk.nɔ
tłum	twum
tłumacze	twuˈma.t͡ʂɛ
tłumaczenie	twu.maˈt͡ʂɛ.ɲɛ
tłumaczyć	twuˈma.t͡ʂɨt͡ɕ
tłumaczyćjakkrowienarowie	twuˈma.t͡ʂɨt͡ɕ jak ˈkrɔ.vʲɛ na ˈrɔ.vʲɛ
tłumaczę	twuˈma.t͡ʂɛ
tłumić	ˈtwu.mʲit͡ɕ
u	u
uaktywnianie	u.ak.tɨvˈɲa.ɲɛ
uaktywniać	u.akˈtɨv.ɲat͡ɕ
uaktywnić	u.akˈtɨv.ɲit͡ɕ
ubek	ˈu.bɛk
ubierający	u.bʲɛ.raˈjɔn.t͡sɨ
ubogi	uˈbɔ.ɡʲi
ubolewać	ˌubɔˈlɛvat͡ɕ
uboższy	uˈbɔʂ.ʂɨ
ubytek	uˈbɨ.tɛk
ubywać	uˈbɨ.vat͡ɕ
ubóstwiać	uˈbu.stfʲat͡ɕ
ucho	ˈuxo
uchodźca	uˈxɔt͡ɕ.t͡sa
uchwyt	ˈu.xfɨt
ucieczka	uˈt͡ɕɛt͡ʂ.ka
ucieczki	uˈt͡ɕɛt͡ʂ.kʲi
uciekający	u.t͡ɕɛ.kaˈjɔn.t͡sɨ
uciekinier	u.t͡ɕɛˈkʲi.ɲɛr
uciekł	ˈu.t͡ɕɛkw
uciekła	uˈt͡ɕɛ.kwa
ucieleśniać	u.t͡ɕɛˈlɛɕ.ɲat͡ɕ
ucieleśnienie	u.t͡ɕɛ.lɛɕˈɲɛ.ɲɛ
uciążliwy	ut͡ɕɔ̃w̃ˈʐlʲivɨ
uczciwszy	ut͡ʂˈt͡ɕif.ʂɨ
uczciwy	ut͡ʂˈt͡ɕivɨ
uczelni	uˈt͡ʂɛl.ɲi
uczelnia	uˈt͡ʂɛlʲɲa
uczenie	uˈt͡ʂɛ.ɲɛ
uczeń	ˈut͡ʂɛɲ
uczony	uˈt͡ʂɔ.nɨ
uczta	ˈut͡ʂt̪a
uczucia	uˈt͡ʂu.t͡ɕa
uczucie	uˈt͡ʂut͡ɕɛ
uczulenie	u.t͡ʂuˈlɛ.ɲɛ
uczy	ˈu.t͡ʂɨ
uczynek	uˈt͡ʂɨ.nɛk
uczyć	ˈut͡ʂɨt͡ɕ
uda	udə
udaje	uˈda.jɛ
udar	ˈu.dar
udawaj	uˈda.vaj
udawaćGreka	uˈda.vat͡ɕ ˈɡrɛ.ka
uderz	ˈu.dɛʂ
uderzać	uˈd̪ɛʐat͡ɕ
uderzenie	ud̪ɛˈʐɛɲɛ
uderzył	uˈdɛ.ʐɨw
udko	ˈut̪kɔ
udręka	uˈdrɛŋ.ka
udziału	uˈd͡ʑa.wu
udziwniać	uˈd͡ʑiv.ɲat͡ɕ
udój	ˈu.duj
ufający	u.faˈjɔn.t͡sɨ
ugrzeczniać	uˈɡʐɛt͡ʂ.ɲat͡ɕ
ujadać	uˈja.dat͡ɕ
ujebać	uˈjɛ.bat͡ɕ
ujemny	uˈjɛmnɨ
ujgurski	ujˈɡurs̪kʲi
ukorzyć	uˈkɔ.ʐɨt͡ɕ
ukradł	ˈu.kradw
ukraiński	u.kraˈiɲ.skʲi
ukraść	ˈu.kraɕt͡ɕ
ukrywa	uˈkrɨ.va
ukrywać	uˈkrɨvatɕ
ukryć	ˈukrɨt͡ɕ
układ	ˈu.kwat
układscalony	ˈu.kwat st͡saˈlɔ.nɨ
ul	ul
ulga	ˈul.ɡa
ulic	ˈulɪts
ulica	uˈlit͡sa
ulicach	uˈlʲi.t͡sax
ulicami	u.lʲiˈt͡sa.mʲi
ulice	ˈulɪt͡sɛ
ulico	uˈlit͡sɔ
ulicom	uˈlʲi.t͡sɔm
ulicy	uˈlit͡sɨ
uliczka	uˈlʲit͡ʂ.ka
ulicą	uˈlʲi.t͡sɔ̃
ulicę	uˈlit͡sɛ
ulotka	uˈlɔt.ka
ultramaryna	ul.tra.maˈrɨ.na
umarł	ˈu.marw
umarła	uˈma.rwa
umiar	ˈu.mʲar
umiarkowanie	uˌmʲar.kɔˈva.ɲɛ
umie	ˈu.mʲɛ
umiejętności	u.mʲɛ.jɛnˈtnɔɕ.t͡ɕi
umiejętność	umjɛˈjɛw̃t̪n̪ɔɕt͡ɕ
umiejętny	u.mʲɛˈjɛn.tnɨ
umiem	ˈu.mʲɛm
umierający	u.mʲɛ.raˈjɔn.t͡sɨ
umieć	ˈu.mʲɛt͡ɕ
umięśnieni	ũmʲjẽĩ̯ɕˈɲẽɲi
umięśniony	ũmʲjẽĩ̯ɕˈɲɔ̃n̪ɨ
umowa	uˈmɔva
umowie	uˈmɔ.vʲɛ
umowy	uˈmɔ.vɨ
umowę	uˈmɔ.vɛ
umrze	ˈum.ʐɛ
umrzesz	ˈum.ʐɛʂ
umrzeć	ˈũmʐɛt͡ɕ
umrę	ˈu.mrɛ
umysł	ˈũmɨsw̥
umywaćręce	uˈmɨ.vat͡ɕ ˈrɛn.t͡sɛ
umyćsię	ˈumɨt͡ɕɕɛ
unaoczniać	u.naˈɔt͡ʂ.ɲat͡ɕ
undekan	unˈdɛ.kan
unia	ˈuɲja
unicestwiać	u.ɲiˈt͡sɛ.stfʲat͡ɕ
unicestwić	u.ɲiˈt͡sɛ.stfʲit͡ɕ
uniform	ˈjuːnɪfɔːm
unik	unik
unikający	u.ɲi.kaˈjɔn.t͡sɨ
uniwersytet	uɲiˈvɛrs̪ɨt̪ɛt̪
uodparniać	u.ɔtˈpar.ɲat͡ɕ
uosabiać	u.ɔˈsa.bʲat͡ɕ
uotwarte	u ɔˈtfar.tɛ
upadać	uˈpa.dat͡ɕ
upadłość	uˈpa.dwɔɕt͡ɕ
upadły	uˈpa.dwɨ
upartyjakosioł	uˈpar.tɨ jak ˈɔ.ɕɔw
upał	ˈu.paw
upaść	ˈu.paɕt͡ɕ
upgrade	ˈʌp.ɡɹeɪd
upiecdwiepieczenienajednymogniu	ˈu.pʲɛt͡s dvʲɛ pʲɛˈt͡ʂɛ.ɲɛ na ˈjɛd.nɨm ˈɔɡ.ɲu
upierdliwy	u.pʲɛrˈdlʲi.vɨ
upierdolić	u.pʲɛrˈdɔ.lʲit͡ɕ
upiorny	uˈpʲɔr.nɨ
upiór	ˈu.pʲur
upokarzający	u.pɔ.ka.ʐaˈjɔn.t͡sɨ
upokorzenie	upɔkɔˈʐɛɲɛ
upośledzać	u.pɔɕˈlɛ.d͡zat͡ɕ
upośledzenie	u.pɔɕ.lɛˈd͡zɛ.ɲɛ
upośledzony	u.pɔɕ.lɛˈd͡zɔ.nɨ
upraszczać	uˈpraʂ.t͡ʂat͡ɕ
uprawa	uˈpra.va
uproszczenie	u.prɔʂˈt͡ʂɛ.ɲɛ
uprzedzać	upˈʂɛ.d͡zat͡ɕ
uprzedzenie	up.ʂɛˈd͡zɛ.ɲɛ
uprzedzić	upˈʂɛ.d͡ʑit͡ɕ
uprzejmy	uˈpʂɛjmɨ
uprząż	ˈup.ʂɔŋʂ
upust	ˈu.pust
upuścić	uˈpuɕ.t͡ɕit͡ɕ
uran	ˈu.ran
uratować	uraˈt̪ɔvat͡ɕ
uratował	u.raˈtɔ.vaw
urlopmacierzyński	ˈur.lɔp ma.t͡ɕɛˈʐɨɲ.skʲi
urobek	uˈrɔ.bɛk
urodzenie	u.rɔˈd͡zɛ.ɲɛ
urodzin	uˈrɔ.d͡ʑin
urodzinowy	u.rɔ.d͡ʑiˈnɔ.vɨ
urodziny	urɔˈd͡ʑinɨ
urodzić	uˈrɔ.d͡ʑit͡ɕ
urojony	u.rɔˈjɔ.nɨ
urok	ˈu.rɔk
urolog	uˈrɔ.lɔk
urzekać	uˈʐɛ.kat͡ɕ
urząd	ˈuʐɔnt
urzędas	uˈʐɛn.das
urągać	uˈrɔŋ.ɡat͡ɕ
usiądź	ˈu.ɕɔɲt͡ɕ
usiąść	ˈu.ɕɔɲɕt͡ɕ
usnąć	ˈus.nɔɲt͡ɕ
uspokój	uˈspɔ.kuj
usposabiać	u.spɔˈsa.bʲat͡ɕ
usposobienie	u.spɔ.sɔˈbʲɛ.ɲɛ
ust	ust
usta	ˈusta
ustach	ˈu.stax
ustami	uˈsta.mʲi
ustawa	uˈsta.va
usterka	uˈstɛr.ka
ustny	ˈustnɨ
usłyszałem	u.swɨˈʂa.wɛm
ułamek	ˈuwamɛk
ułatwiać	uˈwat.fʲat͡ɕ
ułomny	uˈwɔm.nɨ
w	ˈdʌbl̩.juː
wabik	ˈva.bʲik
wabić	ˈva.bʲit͡ɕ
wacha	ˈva.xa
wachlarz	ˈvaxlaʂ
wachta	ˈvax.ta
wadera	vaˈdɛ.ra
wadzić	ˈva.d͡ʑit͡ɕ
wafel	ˈʋaːfəl
wafelek	vaˈfɛ.lɛk
waga	ˈwaɡa
wagary	vaˈɡa.rɨ
wagon	wæɡ.ən
wahadłowiec	va.xaˈdwɔ.vʲɛt͡s
wahający	va.xaˈjɔn.t͡sɨ
wajcha	ˈvajxa
wakacje	vaˈkat͡sʲjɛ
walce	ˈval.t͡sɛ
walczy	ˈval.t͡ʂɨ
walczyć	ˈvalt͡ʂɨt͡ɕ
walczył	ˈval.t͡ʂɨw
walentynki	valɛnˈtɨnki
walet	ˈvalɛt
walina	vaˈlʲi.na
waliza	vaˈliza
walizka	vaˈlʲis̪ka
walićkonia	ˈva.lʲit͡ɕ ˈkɔ.ɲa
walka	ˈvalka
walki	ˈval.kʲi
walkę	ˈval.kɛ
walny	ˈval.nɨ
waloński	vaˈlɔɲ.skʲi
waluta	vaˈlut̪a
wam	wam
wami	ˈwamʲi
wampir	ˈvampir
wanad	ˈva.nat
wanna	ˈwɑ.nə
wapień	ˈva.pʲɛɲ
wapno	ˈvap.nɔ
wapń	vapɲ
wara	ˈva.ra
waran	ˈva.ran
warchlak	ˈvar.xlak
warchoł	ˈvar.xɔw
warczeć	ˈvar.t͡ʂɛt͡ɕ
wardęga	varˈdɛŋ.ɡa
wariat	ˈvar.jat
warka	ˈvar.ka
warownia	vaˈrɔv.ɲa
warstwa	ˈvars̪t̪fa
warszawa	varˈʂa.va
warszawiak	varˈʂa.vʲak
warszawianka	var.ʂaˈvʲan.ka
warszawka	varˈʂaf.ka
warsztat	ˈvarʂt̪at̪
warta	ˈvar.ta
wartości	varˈtɔɕ.t͡ɕi
warunek	vaˈrunɛk
warunki	vaˈrun.kʲi
warunkowy	va.runˈkɔ.vɨ
warzucha	vaˈʐuxa
warzywo	vaˈʐɨ.vɔ
warzyć	ˈva.ʐɨt͡ɕ
was	wɒz
wasal	ˈva.sal
wasi	ˈvaɕi
wasz	vaʂ
wasza	ˈvaʂa
wasze	ˈvaʂɛ
waszego	vaˈʂɛɡɔ
waszej	ˈvaʂɛj
waszemu	vaˈʂɛ̃mu
waszmość	ˈvaʂ.mɔɕt͡ɕ
waszych	ˈvaʂɨx
waszym	ˈvaʂɨ̃m
waszymi	vaˈʂɨ̃mʲi
waszą	ˈvaʂɔ̃w̃
wataha	vaˈta.xa
watażka	vaˈtaʂ.ka
wazelina	va.zɛˈlʲi.na
waćpan	ˈvat͡ɕ.pan
wał	vaw
wałach	ˈvawax
waść	vaɕt͡ɕ
waśń	vaɕɲ
ważka	ˈvaʂka
ważki	ˈvaʂ.kʲi
ważna	ˈvaʐ.na
ważniak	ˈvaʐ.ɲak
ważniejszy	vaʐˈɲɛj.ʂɨ
ważny	ˈvaʐ.nɨ
ważyć	ˈva.ʐɨt͡ɕ
wchuj	fxuj
wdomu	ˈvdɔ.mu
wmordęjeża	ˈvmɔr.dɛ ˈjɛ.ʐa
wogóle	vɔˈɡu.lɛ
wporządku	fpɔˈʐɔn.tku
wzamian	ˈvza.mʲan
wąchać	ˈvɔŋ.xat͡ɕ
wądół	ˈvɔn.duw
wągier	ˈvɔŋ.ɡʲɛr
wąs	vɔ̃s
z	zɛd
za	zɑː
zaatakował	za.a.taˈkɔ.vaw
zabalsamować	za.bal.saˈmɔ.vat͡ɕ
zabawa	zaˈba.va
zabawka	zaˈbafka
zabawniejszy	za.bavˈɲɛj.ʂɨ
zabawny	zaˈbav.nɨ
zabawy	zaˈba.vɨ
zabawę	zaˈba.vɛ
zabierający	za.bʲɛ.raˈjɔn.t͡sɨ
zabieranie	za.bʲɛˈra.ɲɛ
zabierz	ˈza.bʲɛʂ
zabierzcie	zaˈbʲɛʂ.t͡ɕɛ
zabierze	zaˈbʲɛ.ʐɛ
zabierzemy	za.bʲɛˈʐɛ.mɨ
zabierzesz	zaˈbʲɛ.ʐɛʂ
zabij	ˈza.bʲij
zabijający	za.bʲi.jaˈjɔn.t͡sɨ
zabijać	zaˈbijat͡ɕ
zabije	zaˈbʲi.jɛ
zabijecie	za.bʲiˈjɛ.t͡ɕɛ
zabijemy	za.bʲiˈjɛ.mɨ
zabijesz	zaˈbʲi.jɛʂ
zabiją	zaˈbʲi.jɔ̃
zabiję	zaˈbʲi.jɛ
zabili	zaˈbʲi.lʲi
zabiorą	zaˈbʲɔ.rɔ̃
zabiorę	zaˈbʲɔ.rɛ
zabić	ˈzabit͡ɕ
zabił	ˈza.bʲiw
zabiła	zaˈbʲi.wa
zabiłem	zaˈbʲi.wɛm
zabiłeś	zaˈbʲi.wɛɕ
zabiły	zaˈbʲi.wɨ
zabobonny	za.bɔˈbɔn.nɨ
zabrali	zaˈbra.lʲi
zabraniający	za.bra.ɲaˈjɔn.t͡sɨ
zabraniać	zaˈbraɲat͡ɕ
zabrać	ˈz̪abrat͡ɕ
zabrała	zaˈbra.wa
zabójcą	zaˈbuj.t͡sɔ̃
zabójstwo	zaˈbujstfɔ
zachcianka	zaxˈt͡ɕan.ka
zaChinyludowe	za ˈxʲi.nɨ luˈdɔ.vɛ
zachodni	zaˈxɔdɲi
zachodnioflamandzki	zaxɔdˌɲɔflaˈmant͡skʲi
zachować	zaˈxɔvat͡ɕ
zachowuje	za.xɔˈvu.jɛ
zachowujesz	za.xɔˈvu.jɛʂ
zachód	ˈzäxut
zachęcać	zaˈxɛn.t͡sat͡ɕ
zachęta	zaˈxɛn.ta
zaciesz	ˈza.t͡ɕɛʂ
zacniejszy	zat͡sˈɲɛj.ʂɨ
zacny	ˈzat͡s.nɨ
zaczekaj	zaˈt͡ʂɛ.kaj
zaczekajcie	za.t͡ʂɛˈkaj.t͡ɕɛ
zacznie	ˈzat͡ʂ.ɲɛ
zaczniecie	zat͡ʂˈɲɛ.t͡ɕɛ
zaczniemy	zat͡ʂˈɲɛ.mɨ
zaczniesz	ˈzat͡ʂ.ɲɛʂ
zacznij	ˈzat͡ʂ.ɲij
zacznijcie	zat͡ʂˈɲij.t͡ɕɛ
zacznijmy	zat͡ʂˈɲij.mɨ
zaczną	ˈzat͡ʂ.nɔ̃
zacznę	ˈzat͡ʂ.nɛ
zaczyna	z̪aˈt͡ʂɨ̃n̪a
zaczynający	za.t͡ʂɨ.naˈjɔn.t͡sɨ
zaczynasz	zaˈt͡ʂɨ.naʂ
zacząć	ˈzat͡ʂɔɲt͡ɕ
zaczął	ˈza.t͡ʂɔ̃w
zacząłem	zaˈt͡ʂɔ̃.wɛm
zacząłeś	zaˈt͡ʂɔ̃.wɛɕ
zaczęli	zaˈt͡ʂɛ̃.lʲi
zaczęliśmy	za.t͡ʂɛ̃ˈlʲiɕ.mɨ
zaczęła	zaˈt͡ʂɛ̃.wa
zaczęłam	zaˈt͡ʂɛ̃.wam
zaczęłaś	zaˈt͡ʂɛ̃.waɕ
zaczęło	zaˈt͡ʂɛ̃.wɔ
zaczęły	zaˈt͡ʂɛ̃.wɨ
zad	zat
zadawaćsię	zaˈda.vat͡ɕ ɕɛ
zadać	ˈza.dat͡ɕ
zadowolony	za.dɔ.vɔˈlɔ.nɨ
zadośćuczynienie	za.dɔɕ.t͡ɕu.t͡ʂɨˈɲɛ.ɲɛ
zadupie	zaˈdu.pʲɛ
zadzwoni	zad͡zˈvɔ.ɲi
zadzwonić	zaˈd͡zvɔɲit͡ɕ
zadzwonię	zad͡zˈvɔ.ɲɛ
zadzwonił	zad͡zˈvɔ.ɲiw
zadzwoń	ˈz̪ad͡z̪vɔ̃ɲ
zagajnik	zaˈɡaj.ɲik
zaganiacz	zaˈɡa.ɲat͡ʂ
zaginął	zaˈɡʲi.nɔ̃w
zagramaniczny	ˌza.ɡra.maˈɲit͡ʂ.nɨ
zagranica	za.ɡraˈɲi.t͡sa
zagraniczny	za.ɡraˈɲit͡ʂ.nɨ
zagroda	zaˈɡrɔ.da
zaimek	ˈzaimɛk
zaimki	zaˈimci
zainsynuować	za.in.sɨ.nuˈɔ.vat͡ɕ
zaiste	zaˈi.stɛ
zaiwanić	za.iˈva.ɲit͡ɕ
zaiście	zaˈiɕ.t͡ɕɛ
zajawka	zaˈjaf.ka
zajazd	ˈzajast
zajebawszy	za.jɛˈbaf.ʂɨ
zajebać	zaˈjɛ.bat͡ɕ
zajebisty	z̪ajɛˈbʲis̪t̪ɨ
zajebiście	za.jɛˈbʲiɕ.t͡ɕɛ
zajekurwabiście	za.jɛˌkur.vaˈbiɕ.t͡ɕɛ
zajmie	ˈzaj.mʲɛ
zajmiemy	zajˈmʲɛ.mɨ
zajmij	ˈzaj.mʲij
zajmuje	zajˈmu.jɛ
zajmujesz	zajˈmu.jɛʂ
zajmuję	zajˈmu.jɛ
zajmę	ˈzaj.mɛ
zając	ˈza.jɔnt͡s
zajączek	ˈz̪ajɔnt͡ʂɛk
zajął	ˈza.jɔ̃w
zajęcie	zaˈjɛɲ.t͡ɕɛ
zajęczak	zaˈjɛn.t͡ʂak
zajęta	zaˈjɛn.ta
zajęty	z̪aˈjɛn̪t̪ɨ
zajęło	zaˈjɛ̃.wɔ
zakalec	zaˈka.lɛt͡s
zakazanamorda	za.kaˈza.na ˈmɔr.da
zakazać	zaˈkazat͡ɕ
zakała	zaˈka.wa
zakaźny	zaˈkaʑ.nɨ
zakażać	zaˈka.ʐat͡ɕ
zaklęcie	zakˈlɛɲ.t͡ɕɛ
zakochany	zakɔˈxanɨ
zakonnica	za.kɔnˈɲi.t͡sa
zakonnik	z̪aˈkɔɲːik
zakreślacz	zaˈkrɛɕ.lat͡ʂ
zakrzywiony	zak.ʂɨˈvʲɔ.nɨ
zakręt	ˈza.krɛnt
zakrętka	zaˈkrɛn.tka
zakupy	zaˈkupɨ
zakładający	za.kwa.daˈjɔn.t͡sɨ
zakładka	zaˈkwat.ka
zakładnik	zaˈkwadɲik
zakłócać	zaˈkwu.t͡sat͡ɕ
zaległość	zaˈlɛɡwɔɕt͡ɕ
zalew	ˈza.lɛf
zależało	za.lɛˈʐa.wɔ
zależy	zaˈlɛ.ʐɨ
zaliczka	zaˈlʲit͡ʂ.ka
zalotnik	zaˈlɔt.ɲik
zalążek	zaˈlɔŋ.ʐɛk
załatw	ˈza.watf
załatwię	zaˈwat.fʲɛ
załatwił	zaˈwat.fʲiw
zgóry	ˈzɡu.rɨ
zkosmosu	skɔsˈmɔ.su
zpolskiegonanasze	spɔlˈskʲɛ.ɡɔ na ˈna.ʂɛ
zprzewagąkupy	spʂɛˈva.ɡɔ̃ ˈku.pɨ
zrzędu	ˈzʐɛn.du
